Unnamed: 0,id_prompt,title,essay,c1,c2,c3,c4,c5,score
4589,94,,"Segundo o filósofo George Santayana, aqueles que não conseguem lembrar o passado estão condenados a repeti-lo. Analisando o pensamento e relacionando-o a realidade atual, é notório que os preconceitos afetam de forma evidente a sociedade atual, já que a inclusão de pessoas com transtornos é complicada e dificilmente colocada em ação. Além de que o problema está inserido em todo o sistema educacional, em virtude de que todos os dias é comum presenciar diversos preconceitos e falta de oportunidades para pessoas portadoras de transtornos, - e apesar de ser um assunto de extrema importância, nunca é discutido em escolas ou em casa - então novamente a sociedade comete o mesmo erro e sofre com as mesmas consequências, mas ainda assim ignorando o assunto. Nessa perspectiva, pode-se afirmar que o descaso governamental com a educação, a escassa abordagem do autismo e outros transtornos em instituições de ensino e na mídia causam o agravamento da falta de inclusão e a nenhuma resolução para essa situação mais uma vez.De acordo com Nelson Mandela, ex-presidente da África do Sul, a educação é a arma mais poderosa que se pode usar para mudar o mundo. Sendo assim, é possível compreender que a educação e a abordagem do assunto em redes de comunicação assumem importantes papéis no presente e também no futuro da sociedade, entretanto o sistema educacional recebe grande negligência governamental, proporcionando a carência de conteúdos importantes, tal como a inclusão que pessoas autistas merecem.Portanto, fica evidente a importância dos estudos sobre maneiras de inclusão de pessoas com transtornos, e da falta que uma atenção maior para o sistema educacional gera ao país. Consequentemente cabe ao governo e ao Ministério da Educação elevarem a qualidade do conhecimento , por meio da inclusão de novas matérias, conteúdos e atividades – que devem ser acessíveis para todos os tipos de instituições – com o propósito de orientar e educar a todos sobre o grande desafio que é a inclusão. Em vista disso, ensinando as crianças e jovens a importância da abordagem desse assunto, assim educando o cidadão para que no futuro isso já não seja mais um problema e sim apenas uma lembrança de como evoluímos e deixamos preconceitos e exclusão de pessoas autistas no passado.",160,120,120,160,160,720
4765,87,A Cultura da Erotização Infantil,"A cultura da erotização infantil é um problema que está cada vez mais presente na sociedade, via momentos não são percebidos pelos adultos, como cenas sensuais de novelas, séries ou filmes, letras de músicas que depreciam e vulgarizam o ato sexual ou algum gênero específico, principalmente o feminino, que estimulam comportamentos e pensamentos impróprios para crianças. São situações que merecem a devida atenção dos pais ou responsáveis para que sejam evitados transtornos futuros para si mesmos e para a prole.Séries, filmes e novelas são produtos de entretenimento consumidos por todas as idades e perfis. Essas produções têm classificações etárias, que nem sempre são respeitadas, por conta principalmente da negligência familiar. Nesse cenário, as crianças têm acesso amplo a conteúdos com forte apelo erótico, que de alguma maneira os inspiram a reproduzirem certos comportamentos que não condizem com a idade que possuem, sendo manifestado na vestimenta ou na forma de falar, por exemplo. A família deve monitorar o que os filhos assistem para evitar que esse tipo de situação ocorra em suas casas, prevenindo danos para o desenvolvimento físico e mental da criança.Letras musicais são outra maneira de fomentar a cultura da erotização infantil, em que muitas delas depreciam e vulgarizam o sexo e um gênero, sobretudo feminino, utilizado palavras de baixo calão em alguns casos. São composições que podem introjetar na mentalidade das crianças comportamentos de cunho machista e misógino que hipersexualizam o corpo humano, principalmente de mulheres, que podem prejudicar na forma com que elas, na fase adulta, se relacionarão com o sexo oposto. Novamente, é preciso que os pais monitorem as músicas escutadas pelos seus filhos e dialoguem com eles, de forma a desconstruir qualquer pensamento negativo oriundo de tais composições musicais.Um caminho que pode ser adotado na luta contra a cultura da erotização infantil pelo governo são campanhas publicitárias voltadas para as famílias das crianças que conscientizem elas da importância do monitoramento do conteúdo consumido por seus filhos, de forma que estimulem esses familiares a serem mais atuantes na vida das crianças, evitando que esse processo continue a estimular a adoção inconsciente de comportamentos inapropriados para determinadas faixas etárias.A cultura da erotização infantil é um problema recorrente na sociedade atual, sendo fomentadas através de alguns momentos que passam despercebidos dos adultos, como cenas sensuais de novelas, séries ou filmes, letras de músicas que depreciam e vulgarizam o ato sexual ou algum gênero específico, principalmente o feminino. É um problema que tem solução, basta o governo auxiliar os pais a tomarem consciência da importância deles na vida dos seus filhos.",160,160,120,120,120,680
4778,87,A EROTIZAÇÃO PREMATURA (VI),"A erotização infantil se caracteriza pela exposição a conteúdos e situações que incitam a sexualidade prematura. O que tem se tornado mais comum, devido as opções para a propagação desse tipo de conteúdo. As mídias sociais e brincadeiras entre familiares com conotações sexuais, resultam na proximidade da petiz com a voluptuosidade.O contato com esses conteúdos impróprios impulsionam a sua curiosidade. Tendo por conseguinte a perda de sua puerícia, que acaba replicando a sexualidade que lhe foi apresentada em seu cotidiano, como brincadeiras e gestos. Tornando as crianças mais vulneráveis á violência e ao abuso sexual.Assim a prevenção é a melhor medida. Sobretudo é importante deixar as crianças se desenvolverem em um ritmo saudável e próprio. Com cuidados e supervisões de seus responsáveis em relação as mídias sociais, dispositivos eletrônicos e orientações sobre atividades adequadas à idade, assim como a comunicação com os pais. Destarte as crianças são introduzidas a sexualidade de forma natural e no tempo adequado.",160,120,120,120,120,640
4798,87,As mídias e a erotização infantil,"Em virtude do cenário atual a erotização infantil é um assunto que causa cada vez mais preocupação em especialistas e pesquisadores. E com a chegada das mídias sociais esta questão vem se agravando evidentemente.O amadurecimento precoce de crianças causa a distorção de fases essenciais do desenvolvimento humano, como a diminuição da infância, prejudicando, além do crescimento físico e psicológico destas crianças, as relações com seus responsáveis, por isso este impasse vem atraindo olhares dos mais diferentes especialistas, como a psicopedagoga e psicopatóloga Iane Cruz Obando, que afirma ser necessário aprofundar o tema para compreender mais concretamente suas causas.O fácil e rápido acesso de crianças às mais diversas mídias, como televisão, redes sociais, propagandas, sites e filmes, que possuem conteúdos prematuros às suas idades, tornaram a indução de crianças a determinados comportamentos não propícios a sua condição de criança, muito mais frequentes e perigosos. Por exemplo, o TikTok, mídia que fez muito sucesso no período de quarentena entre pessoas das mais diversas idades, foi uma explosão de erotização infantil, onde a exposição da sexualização precoce de crianças ficou evidente.Em vista disso, é dever do Ministério Público Federal fiscalizar o cumprimento do artigo 227 da Constituição federal de 1988 e dos artigos 75, 240 e 241 do Estatuto da Criança e do Adolescente, leis responsáveis por garantir a segurança e o bem-estar da população brasileira e, no caso específico do Estatuto da Criança e do Adolescente, dos brasileiros menores de 18 anos. Esta ação deve ser realizada por intermédio de averiguações mais rápidas e eficazes de representações, com o intuito de que haja punição aos responsáveis pela publicação e difamação de conteúdos causadores de erotização infantil.",200,160,120,160,160,800
4799,87,Combate a erotização infantil,"Atualmente as crianças e adolescentes estão se desenvolvendo muito cedo, e se vulgarizando com roupas curtas e decotadas, maquiagens muito pesadas para suas idades, ao invés de curtirem e aproveitarem suas infâncias e respectivas idades.Isso acontece pois as crianças e adolescentes não estão tendo a devida educação para entenderem a situação a que estão sendo expostas. Alguns pais não conversam com seus filhos sobre suas sexualidades e outros até incentivam sua adultização muito cedo por acharem bonito ou algo bastante atual nos dias de hoje, incentivando assim a erotização sexual. A sexualidade é muito normal desde que seja em seu devido tempo.As escolas também não fazem seu papel, em razão de que a escola é um lugar de aprendizado e não existe nenhuma aula de educação sexual nas escolas brasileiras que ensinem os alunos de forma apropriada e de maneira correta.Portanto o governo deve impor nas escolas aulas sobre educação sexual, criar projetos e campanhas que ensinem as crianças e os adolescentes, e os pais devem conversar com seus filhos e ensinar sobre suas sexualidades.",200,120,120,120,120,680
4816,87,Distopia Infantil,"Em um episódio da série “ Black Mirror” , da streaming Netflix, é abordado um contexto da sexualidade infantil, no qual um jovem realiza atos libidinosos ao visualizar fotos de crianças na internet. Logo, faz-se necessário a análise desse pressuposto no contexto atual . A partir do momento em que , no Brasil, há alta taxas de casos de erotização de crianças. Sendo assim, entende-se que a valorização da sexualidade em menores no dia a dia e o uso das redes de comunicação para esse fim inferem como precursor da problemática.Em primazia, atos comuns envolvendo a sexualidade infantil servem como uma das prerrogativas desse percalço. Logo, comumente usados, os termos “Novinha/Novinho” servem para designar a preferência sexual aos menores de dezoito anos na sociedade. Apesar de que muitas vezes usados sem a intenção, há a compreensão de que esses termos tem raízes no fenômeno da erotização de menores. No entanto, os efeitos dessa cultura tem consequências horríveis , a partir do momento que compromete a vida de jovens e crianças, que no final são abusadas e vistas como objetos de desejo e consumo de maiores, tirando delas sua inocência e colocando em risco o proveito de parte de suas vidas responsáveis pela juventude e infância. Desse modo, compreende-se a gravidade do problema em questão.Outrossim, o amplo acesso ao mundo virtual para fins de erotização e abuso infantil contribui para a problemática. Dessa forma, o que espera-se dos meios de informação é nada mais que uma aliança em prol da luta contra a cultura da valorização da sexualidade infantil, entretanto colocam-se como portas abertas para a ocorrência dessa distopia. Entende-se isso a partir do momento em que a existência de revistas como a “Playboy”, de sites pornográficos como o “XVídeos” ou fóruns de encontros sexuais contribuem para a procura de menores a fim da ocorrência de abusos e assédios movidos pela valorização de suas sexualidades. Com isso, há a reflexão do quanto o ambiente digital , local de fácil busca de dados e manipulação de informações , propicia para atos criminosos contra crianças. Dessa maneira , faz-se mister o quanto o mau uso das redes maximiza o desafio.Em suma, é preciso soluções para os problemas vigentes. Portanto, é dever do Ministério da Cidadania, por meio do Ministério das Comunicações, criar uma campanha de conscientização sobre a exposição sexual de crianças na sociedade, com o auxílio das próprias mídias digitais e sociais , ocorrendo de forma a inibir também a atuação de sites pornográficos ou abuso e assédio aos menores no meio digital, a fim de que os casos de erotização sejam diminuídos e que a sociedade entenda a importância da resolução desse problema. Em síntese, acontecimentos como o descrito na série “ Black Mirror” não serão mais o reflexo da sociedade brasileira.",160,160,160,200,160,840
4817,87,Educação sexual x sexualização,"Durante a Idade Média os corpos infantis eram retratados nos quadros como adultos em miniatura, pois naquela época a infância era pouco valorizada e vista apenas, como uma passagem do nascimento para a vida adulta. Atualmente, há diversos estudos referentes ao mundo infantil. Com isso, as crianças possuem a liberdade de serem quem são e aproveitarem essa fase de maneira lúdica e curiosa. Por outro lado, essa mesma liberdade tem trazido conflitos e despertado a sexualidade precoce delas, o que pode causar um aceleramento para a vida adulta e desencadear transtornos psicológicos no futuro. Além disso, com a exposição em rede, consequentemente pode abrir espaços para pedófilos.Contudo, as crianças devem ser orientadas a evitarem a exposição excessiva nas redes sociais, pois através da aceleração de informações proporcionadas pela tecnologia, muitos pedófilos tem se aproveitado disso para cometer seus crimes . Sendo assim, os pais devem acompanhar os filhos em suas comunicações em redes para a proteção da infância. No entanto, referente a sexualidade infantil, é de suma importância a família tratar esses assuntos para o desenvolvimento e educação sexual, o que pode evitar possíveis abusos sexuais e até mesmo assédios no mundo virtual.Por outro lado, muitos pais involuntariamente acabam envolvendo as crianças demais nesse ambiente de sexualização dos corpos, eles não ensinam a educação sexual e sim, a erotização infantil por meio de conteúdos de filmes, novelas e músicas, e até mesmo cenas do dia a dia, a infância vai sendo tomada por essa sexualidade adulta, através de palavras, gestos, danças e atitudes inapropriadas para a idade delas . Isso pode levar a adultização e desencadear sérios problemas no que se refere a vida sexual precoce, e até mesmo a gravidez na adolescência.Portanto, no que tange a educação sexual, as escolas devem proporcionar orientações por meio de reuniões de pais, alertando-os sobre os possíveis problemas gerados para seus filhos em relação a interferência de incentivo a sexualidade adulta na sexualidade infantil. No mais, as instituições de ensino deverão desenvolver junto ao seu corpo docentes, atividades elaboradas para trabalhar assuntos atuais sobre a sexualização infantil, por meio da educação sexual.",160,160,160,200,160,840
4820,87,Erotização infantil,"O filme Cuties, lançado pela empresa de entretenimento Netflix, levantou um grande público enfurecido, o qual alegava que tal obra cinematográfica expunha atrizes, de até 14 anos, de uma maneira muito vulgar, com roupas sensuais e posições eróticas. Justificativas como “Ah, mas o filme não foi feito para o público infantil” foram utilizadas por muitos como uma tentativa de defesa a longa-metragem. Por outro lado, é questionável o porquê dos protagonistas do elenco serem crianças se o filme, a princípio, seria direcionado ao público adulto.A fase da infância possui uma grande relevância na formação individual, tendo que disputar lugar com a sexualidade precoce, influenciada por meios externos, como conteúdos infantis recheados de conotações sexuais ou trazidas por pessoas pertencentes ao ciclo de convivência e confiança da criança, fazendo com que atitudes adultas sejam alvo de busca dos pequenos, como a utilização de uma roupa mais sensual, por exemplo.A extrema erotização infantil nas mídias abre largas portas à pedofilia, desencadeando uma rede de crimes sexuais cometidos com crianças. Parafraseando o comentário da neuropsicóloga Deborah Moss à revista MdeMulher, é possível reafirmar a importância da fase infantil na vida dos indivíduos, e o perigo que pular etapas pode trazer a formação dos mesmos, sendo necessária uma onda de conscientização advinda da tríade Estado, escola e mídia.Diante dos fatos apresentados, fica evidente a urgência de medidas visando a proteção dos pequenos, direito assegurado constitucionalmente. O Estado, com seus três poderes, poderia colocar em prática as leis protecionais já existentes. A escola, como instituição educadora, completaria a missão fazendo campanhas de conscientização com crianças e pais, como conversas interativas com psicólogos e profissionais da comunicação. A mídia por sua vez, como quarto poder, seria responsável por realizar campanhas pontuando os perigos da erotização infantil e derrubar páginas e sites onde há o incentivo à sexualização precoce.",200,160,120,120,160,760
4861,87,"Pequenos em Tamanho, Grandes em Problemas","Em um mundo globalizado e dinamicamente tecnológico como a sociedade encontra-se, não é incomum perceber a participação serôdia das pequenas faixas etárias ao universo da internet, já que desde a mais tenra idade a criança é submetida a ele. No entanto, tal aproximação não produz somente qualidades, mas também grandes problemas à formação do indivíduo, como é o caso da erotização precoce.Ainda em estágio de amadurecimento, esta população é desprovida de certos discernimentos; e o fácil acesso a conteúdos sexualmente explícitos, principalmente nos meios digitais, atrelados ao desejo pessoal de conhecer seu próprio corpo, os faz querer compreender o processo sexual sem ter as qualificações necessárias para tanto, tornando-os vítimas de uma alienação sem limites, sendo influenciados por terceiros no modo de pensar, agir, vestir, entre outros, colocando em risco a boa conduta na sociedade na qual serão futuramente inseridos. Consoante a isto, o processo de maturidade mental, social e psíquica da juventude é antecipado, causando uma adesão rápida ao mundo adulto que traz altos malefícios para todos.A mídia e as redes sociais são as maiores influenciadoras neste processo, pois a erotização infantil é constantemente utilizada por sites e até mesmo pelo mercado de filmes como objeto de venda. Contudo, outros fatores podem ser creditados a esta prática, como a negligência dos pais, da escola e demais grupos sociais no que tange a correta educação sexual de menores e a falta de atenção dos mesmos no comportamento digital das crianças.Portanto, é necessária a participação efetiva do governo, das autoridades educacionais e médicas e das famílias na criação de uma ação de combate nacional, divulgada na internet, nas escolas e nos estabelecimentos de saúde que proporcione uma educação sexual sadia, por meio de palestras e vídeos com professores e especialistas, ensinando critérios corretos de corpo e mente, para que a infância possa ter à sua disposição uma fonte segura de ensino. A maior rigidez no controle e fiscalização de sites e outros meios de comunicação que pratiquem a erotização também seria uma forte impulsionadora para corroborar com a extinção desta prática no espaço virtual e social, levando os responsáveis à justiça. Com isso, compreendemos que este mal será, em pouco tempo, diminuído e praticamente inexistente no país, para que as crianças do presente proporcionem adultos conscientes do futuro.",200,160,160,120,160,800
4866,87,Sexualização infantil,"Não é novidade que com a chegada da internet e o mundo das mídias sociais as pessoas estão expondo cada vez mais suas vidas online, uma das formas de exposição mais sensíveis que há é envolvendo crianças.Atualmente é cada vez mais comum observar crianças com um comportamento impróprio para sua idade, em alguns lugares vira um requisito, como se fosse necessário tal adultização, elas que muitas vezes influenciadas pela mídia desejam aparentar e agir como se fossem mais velhas tentam pular fases essenciais da vida para seu crescimento, se mostram de forma sexualizada tanto online quanto em seu cotidiano. De forma geral, apresentam aspectos não saudáveis que não condizem com a sua idade, coisa que é prejudicial para a criança e poderá afetar seu desenvolvimento futuro, a infância é uma parte crucial da vida de qualquer pessoa e jamais deve ser negligenciada.No entanto é de suma importância que os pais fiquem atentos e não tentem incentivar tal comportamento em seus filhos, procurem supervisionar os conteúdos consumidos pelos pequenos e manter hábitos condizentes com a idade da criança.",160,120,120,120,120,640
4872,87,Um dever dos adultos com as crianças,"A erotização de mulheres é muito comum, o que é um grave problema no mundo, mas um problema ainda mais grave quando essa erotização começa na infância e adolescência, de acordo com o Psicanalista Freud é onde se é desenvolvido o caráter, afeições e construções psicológicas para um adulto emocionalmente e psicologicamente saudável.No livro Lolita de Vladimir Nabokov, é nos apresentado um homem que está interessado em uma menina de 12 anos de idade, onde ele relata os desejos e paixões pela jovem, a crítica da obra para algumas pessoas seria muito simples, considerar a paixão de um adulto por uma criança é errado e crime, porém surgem outras interpretações da obra.Esse fato nos faz refletir em como a criança sofre objetificação, e a forma como o narrador descreve-a traz essa erotização do corpo infantil, o livro apesar de ser de 1955 é muito atual, pois, ainda hoje é possível acessar em redes sociais, posts feitos em sua maioria por homens, comentando em fotos com tom sexual, pejorativo e em alguns casos acediosos de meninas muitas vezes menores de idade, o que contribui para essa cultura de erotização do corpo infantil.Contudo, alguns meios podem ser tomados para a diminuição desses casos, como o acesso à internet controlado por pais de menores de idades, controle maior de redes sociais para menores, mas acima de tudo uma maior fiscalização e denúncia dessas pessoas que comentam e incentivam crianças e adolescentes a postarem fotos de biquíni, em poses sexualizadas, entre outras.Deste modo, com a conscientização e colaboração de pais e responsáveis e a maior fiscalização e punição de adultos com esse comportamento, é possível criar um ambiente seguro para as crianças e adolescentes na internet, diminuindo assim a cultura da erotização infantil.",160,120,120,160,120,680
4883,88,...,"O machismo é um impasse social que concerne não só as mulheres em seus cotidianos, em ramos profissionais, religiosos e de entretenimento, mas também abrange os homens no que se refere aos estigmas. Haja vista, a visão opressora que esse empecilho social apresenta em relação às doenças mentais de que esses são distúrbios dispensáveis, sendo assim, banalizados o que provoca , consequentemente, malefícios para mulheres e homens. Nessa perspectiva, é necessário mencionar a ausência de informação e a cultura de banalização de transtornos psicológicos como causadoras dessa problemática.Em primeiro lugar, faz-se fundamental citar a deficiência de conhecimento como impulsionadora do conflito em questão. Destarte, as informações limitadas do corpo social brasileiro associadas aos transtornos mentais acabam por, propulsionar o preconceito que existe atribuído a eles. Diante disso, ao dispor do mínimo conhecimento sobre essas doenças, o sujeito tende a julgar aquele que contém a enfermidade, por justamente essa, não apresentar incapacidade visível e, portanto, alimenta esse estigma. Nesse sentido, essa situação é capaz de prejudicar o doente que passar por julgamentos pois o enfermo sente-se sem apoio emocional, ocorrência favorável a sua doença. Dessa maneira, esse fato diverge do pensamento do filósofo John Locke, que visa a necessidade da reflexão sobre as experiências que o ser humano obtém ao longo da vida para desenvolver o conhecimento. Sendo assim, a sociedade brasileira reproduz a intolerância à doença mental sem ao menos cogitar sobre tais transtornos psicológicos.Além disso, é preciso salientar que as doenças da mente são desconsideradas em analogia àquelas físicas. Sob esse viés, os distúrbios mentais são desprezados e possuem pouca atenção por parte da sociedade. À vista disso, essa banalização é retratada pela escassa investigação profissional e também pelo número crescente de suicídios no Brasil. Dessa forma, a cultura de desdenhar esses problemas de saúde provém de um contexto histórico, pois somente no século XXI que a população iniciou o investimento nesse âmbito psicológico . Isto decorreu por existir esse estigma, o que ocasionou sua conservação por muitas gerações.Tendo isso em vista, é dever do Ministério da Saúde realizar consultas psiquiátricas com a comunidade, por meio do Sistema Único de Saúde e necessita priorizar aqueles que dispõem do diagnóstico da enfermidade. Essa ação tem a finalidade de tornar essa área da saúde menos estigmatizada, ao demonstrar que todos carecem de cuidados com a saúde mental. Logo, a cultura de banalizar e estigmatizar serão apenas lembranças da história brasileira.",160,160,160,200,160,840
4912,88,Escrever sobre o que não tenho,"Em “Prisão do Rei”, da autora Victoria Aveyard, o Rei Maven Calore se encontra preso em uma das piores prisões: sua própria mente. Acometido por uma doença mental, o jovem rei não se sente confortável em pedir ajuda, pois acredita que não obteria apoio nenhum, tanto da população, quanto de seus próprios aliados. Da mesma forma que o jovem rei, muitas pessoas ainda carregam estigmas quanto às doenças mentais, problema gerado tanto pela idealização do conceito de felicidade, quanto pela disseminação de um padrão pelas redes sociais.Em primeiro lugar, tem o problema da idealização da felicidade. Para muitas pessoas, ser feliz significa não estar triste em momento nenhum, ou obter prazer por meio da compra de bens materiais. Uma conceitualização errônea, visto que, pelas palavras do filósofo Aristóteles, a felicidade não pode ser entendida como a obtenção de bens materiais ou de cargos importantes, mas está entrelaçada com a virtude, que é a capacidade de fazer o bem ao próximo. Dessa forma, muitas pessoas se iludem com esse conceito e criam estigmas quanto as doenças mentais.Em seguida, tem-se o problema da imposição de um padrão de vida, disseminada pelos meios midiáticos. São divulgados pela internet, principalmente pelas redes sociais, um padrão de beleza a ser seguido para se chegar ao bem-estar e à felicidade. Problemas psicológicos são gerados quando esse padrão não é alcançado, como por exemplo, a depressão, que, no Brasil alcança níveis extremos, pois segundo a OMS , o país foi o mais depressivo da América Latina no ano de 2007.Por fim, medidas devem ser tomadas para que a situação seja resolvida. O Ministério da Saúde – principal órgão responsável pela saúde no país – pode , por meio de subsídios cedidos pelo governo federal, promover propagandas nas redes sociais que eduquem sobre saúde mental. Assim como, em conjunto com as escolas promover programas que ajudem os alunos a lidar com problemas envolvendo a saúde da mente e oficinas que promovam o autoconhecimento. Só assim poderemos ter uma realidade diferente daquela apresentada por Aveyard em seus livros.",160,160,120,200,160,800
4984,88,,"Na Constituição federal brasileira, promulgada em 1988, prevê que todo cidadão tem pleno direito à saúde e bem-estar. Entretanto no Brasil, fica evidente o estigma associado às doenças mentais na sociedade. Nesse sentido, convém analisarmos as principais causas e consequências acerca dessa problemática.Diante de tal cenário, é importante pontuar a falta de informação e atendimento adequado para as pessoas que sofrem de transtornos mentais. De acordo com a Organização Mundial de Saúde, o suicídio - causado pela depressão- fica em 3º lugar em números de mortes no país. É, portanto, inadmissível, que no Brasil ainda não possua clínicas especializadas.Além disso, podemos observar, que a quantidade de indivíduos com problemas mentais aumenta cada vez mais ao longo dos anos. Segundo dados da OMS , as doenças mentais são uma das causas de afastamento do trabalho em todo país. Assim, fica evidente, que medidas precisam ser tomadas de forma urgente, pois as pessoas perdem sua liberdade, como também a sociedade sofre financeiramente.Dessa forma, com intuito de mitigar tal situação, necessita-se, urgentemente, que o Estado, com o apoio do Ministério da Saúde, faça campanhas de conscientização, por meio da mídia, para que tenha maior alcance de indivíduos, a fim de acabar com o preconceito existente acerca dos transtornos mentais e mudar as estatísticas tão alarmantes da OMS.",160,120,120,200,160,760
4990,88,,"A Constituição federal de 1988, norma de maior hierarquia do sistema jurídico brasileiro, prevê o pleno direito à saúde como inerente a todo cidadão. No entanto, o oposto é o que se observa na contemporaneidade, haja vista que, no Brasil, as doenças mentais podem ser associadas a um estigma, o que desencadeia um alarmante problema Nesse sentido, entende-se que essa configuração se deve, essencialmente, à precariedade de investimentos governamentais no que tange à compreensão e ao tratamento dos transtornos psíquicos e à exposição midiática de pessoas aparentemente desprovidas de problemas.Nesse contexto, é válido ressaltar que as doenças mentais, em muitos casos, passam desapercebidos pelo Poder Estatal. Dentro disso, consoante ao filósofo contratualista de John Locke, o Estado é constituído como responsável pelo domínio político para preservar e consolidar os direitos da população. Contudo, infelizmente, compreende-se que isso não se concretiza no Brasil, uma vez o governo não disponibiliza a todos um sistema de saúde pública qualificado para atender as variadas necessidades psíquicas. Consequentemente, permite que o corpo social permaneça emocionalmente ferido, possibilitando o agravamento da situação. Assim, é substancial a resolução dessa conjuntura.Ademais, outro fator contribuinte para tais transtornos são os cenários fantasiosos de vidas perfeitas mostrados na mídia. Dessa forma, segundo o sociólogo francês Émile Durkheim, a coercitividade é um fato social utilizado pela sociedade para impor padrões sociais aos indivíduos que a integram, obrigando-os a cumpri-los. Nessa linha de raciocínio, na realidade hodierna numerosas pessoas desenvolvem uma alienação acerca de estereótipos padronizados, de modo a se sentirem inferiores, o que acarreta diversos sentimentos negativos, até mesmo enfermidades mentais. Logo, é imprescindível a dissolução dessa problemática.Portanto, são necessárias medidas para a erradicação do estigma. Para isso, é preciso que Ministério da Saúde forneça tratamentos específicos para cada problema mental nos hospitais de cada região, por meio do SUS , com acompanhamento de psicólogo, rodas de apoio e, ainda, introduza na mídia relatos de pessoas que já tiveram depressão ou ansiedade, por exemplo, e se curaram, com a finalidade de promover a melhoria eu bem-estar dos brasileiros. Dessa maneira, a previsão da Carta Magna será efetivada no país.",200,200,160,200,160,920
5003,89,A conscientização do isolamento social devido a crise econômica,"O distanciamento social está sendo implantado em nossa sociedade desde o começo da pandemia, e suas consequências apenas foram notadas com mais atenção ao decorrer dela. O governo tenta conscientizar a sociedade de permanecer em distanciamento social, no entanto, temos a necessidade de trabalhar e gerar nossa renda para que possamos nos sustentar, e com o fechamento dos comércios, dificuldades surgem, e essa conciliação gera certas controversas. Nesse período, foi destacado a grande desigualdade de classes que já era recorrente muito antes da pandemia.A crise econômica foi abalada pela pandemia, e não as medidas de isolamento implantadas, ou seja, em lugares onde ocorreu o isolamento com maior vigor, os casos foram menores do que cidades que não o implantaram com maior vigência, assim, as cidades se recuperaram mais rapidamente e consequentemente melhorando sua economia. A quarentena no estado de São Paulo continua sendo estendida, voltando fases e não se estabilizando, esse é um efeito da conscientização da população também, que não possui responsabilidade e organizam festas clandestinas ou saem sem a menor proteção, o vírus se propaga com muita facilidade e quanto maior o número de pessoas infectadas, maior o número de leitos em hospitais ocupados, gerando declínio neles também, o que só agrava a situação da saúde pública.Com os dados apresentados anteriormente, pode-se concluir que existe uma instabilidade no distanciamento social junto ao trabalho, mesmo com o auxílio emergencial e suas grandes filas, a não devida importância da população com os mínimos cuidados de proteção e eventos clandestinos, o que só agrava o cenários que estamos vivendo, e só iremos contornar essa realidade quando todos fizerem sua parte, se conscientizando e tendo responsabilidade.",200,160,120,120,120,720
5005,89,A CONTENÇÃO DA PANDEMIA E A RECUPERAÇÃO FINANCEIRA - VI,"No contexto pandêmico atual, que assolou a população mundial, as medidas sanitárias são as mais eficazes contra sua propagação. A lei 13.979, determina no artigo 3, que podem ser decretadas no combate à epidemia medidas como isolamento e quarentena. Hodiernamente, as medidas de distanciamento têm afetado o setor da economia, gerando graves consequências. Assim mostra-se relevante pensar nesta situação econômica que configura as maiores problemáticas desse pernicioso cenário.De início é notório destacar que as condutas sanitárias têm grande importância no enfrentamento à pandemia, devem ser seguidas e respeitadas, prova disso recai nas reduções de taxas de contaminação e o número de falecimentos entre os contaminados. Ademais cabe ressaltar que as normas acabam afetando vários setores da economia, deixando mais evidentes as desigualdades sociais. No Brasil, o desafio vai além de controlar a pandemia, mas também reduzir a crise econômica. Sendo assim torna-se urgente reconhecer a necessidade de refrear ambas as situações, de modo que garanta a recuperação financeira e conter a epidemia.Com o objetivo de minimizar a crise econômica sem afetar a contenção pandêmica, seria necessária a criação de medidas públicas eficazes. Outrossim cabe aos órgãos governamentais e federais, incentivarem o isolamento evidenciando sua importância, como medida significativa da contenção da transmissão. E como ajuda financeira, a criação de auxílios extras, levando em consideração comerciantes com estabelecimentos fechados, trabalhadores que ficaram sem remuneração, desempregados e a população periférica. Somente assim os cidadãos poderiam respeitar o isolamento, sem passar por dificuldades financeiras, ajudando a economia. Para assim garantir a segurança e a saúde de todos.",160,200,120,160,200,840
5071,89,O isolamento e suas consequências.,"Atualmente, no Brasil, vivemos um estado de calamidade pública, onde mais e mais pessoas estão perdendo seus empregos e, consequentemente, aglomerando-se em frente das centrais de trabalho. Além disso, muitas subestimam o vírus e não seguem os protocolos emitidos pela Organização Mundial da Saúde, como usar máscara e evitar aglomerações.Muitas pessoas perderam seus empregos desde o começo da pandemia, o que causou muita pobreza assim que a quarentena se iniciou. Famílias de baixa renda, segundo o G1, que mal tinha o que comer antes mesmo do vírus, agora vivem em um estado desumano, onde fazem apenas uma refeição por dia. Além de ser uma situação grave, é preocupante, pois em meio uma crise econômica, uma pessoa que não possuía muito dinheiro para comer mesmo recebendo um salário antes da pandemia, após ela, piorou ainda mais a situação.Ainda que exista desempregados, também existe mais e mais aglomerações nas agências bancárias, por conta dos auxílios concedidos do governo para a população. Porém, essas aglomerações não estão sendo respeitadas e muitos cidadães não seguem os protocolos de segurança, o que leva mais pessoas a contraírem o vírus.Portanto, medidas são necessárias para resolver o impasse. O Ministério do Trabalho, junto ao Ministério da Economia, deve propor a abertura de empregos para as famílias mais carentes, por meio de um projeto de lei entregue à Câmara dos Deputados. Essa abertura iria ajudar a diminuir a crise e ajudar as famílias que precisam achar um emprego. Além disso, o governo deveria conceder multas àquelas pessoas que não seguem os protocolos de segurança em lugares públicos. Espera-se, com essa ação, a diminuição do desemprego e o aumento na economia, assim como o aumento do isolamento social.",160,160,120,160,160,760
5072,89,O uso racional do isolamento social,"É cientificamente comprovado que o ser humano é socializável. Quando há algo que coloca em risco esse fator é sempre visto como dificuldade para alguns. É o caso do isolamento social imposto pela Covid-19, doença infecciosa cujo o único tratamento é não ter contato com outras pessoas. Esse fato causa grande discordância entre a população, sendo defendida por uns e atacada por outros.O argumento usado e comprovado por aqueles que defendem o isolamento é de que esse é o que possui maior eficácia contra casos e mortes e que se não aplicado em conjunto com outras cidades ou de forma rígida igualmente para todos os cidadãos não possui nenhum efeito, sendo o fechamento de atividades não essenciais necessário. Todavia, deve-se salientar que a quarentena é o método usado muito antes da pandemia que acontece agora, sendo feita desde a peste bubônica que assolou a Europa no século XIV.Entretanto, há aqueles que discordam dessa postura, em sua maioria dizendo que o fechamento de algumas atividades gerará impactos negativos em seus negócios e na economia, de fato que a pandemia obrigou vários empresários fecharem seus negócios e tirou de casa aqueles que não tinham condições financeiras básicas. Em virtude do que foi colocado anteriormente, a crise foi agravada com uma tempestade de notícias falsas e pessimismo em relação aos métodos cientificamente comprovados, comprometendo ainda mais a doença.Nota-se que o Estado deve criar medidas de apoio por meio de auxílios financeiros para aqueles que dependem da rua ou de atividades não essenciais para viver e sustentar seus entes, para que assim diminua os motivos para se sair de casa. Junto com o que foi apresentado anteriormente, o endurecimento de regras é primordial para um isolamento social eficaz, explicando como o método funciona e deve ser exercido. Desse modo, poderemos conscientizar a população e sair dessa crise retornando à normalidade.",160,160,120,160,160,760
5115,89,,"De acordo o filósofo e pensador chinês, Confúcio, para prever o futuro se deve estudar o passado. A crise econômica e sanitária da Covid-19 que vem sendo um desafio para humanidade nos dias atuais de certa forma assemelha-se ao maior colapso econômico do século XX, a Grande Depressão de 1929. Embora seus motivos tenham sido distintos, a economia foi afetada de forma semelhante, pois em ambos contextos a produção global decaiu radicalmente, assim resultando diversas crises no setor econômico. É um grande absurdo indivíduos que vivem em situação de vulnerabilidade social perderem seus empregos sem previsão de retorno enquanto seus patrões continuam desfrutando de seu capital ilimitadamente.Antes de tudo, é de conhecimento geral que o desemprego é um problema recorrente no Brasil, mas com o estopim da pandemia o número de cidadãos desempregados aumentou de forma drástica. O auxílio emergencial que em tese deveria resgatar a população da crise, infelizmente não cumpriu com seu objetivo. Segundo Aristóteles, o papel da política é manter o bem-estar social, entretanto isso não condiz com nossa realidade mesmo diante de uma pandemia que vem fazendo milhares de vítimas diariamente.Se o Estado fornecesse o devido apoio financeiro e sanitário à população, a dificuldade que está sendo enfrentada poderia ser contida e consequentemente a conjuntura social apresentaria grande melhora e assim a população poderia voltar às suas atividades cotidianas e comerciais com antecedência. Cabe também aos brasileiros exercerem sua cidadania e exigirem suas devidas melhorias e seus direitos como cidadão como consta na Declaração Universal dos Direitos Humanos.Contudo, de acordo com as problemáticas apresentadas, cabe ao Ministério Da Saúde tomar atitudes mais rigorosas em relação às restrições contra o vírus para impedir que o contágio continue se propagando e oferecer também um suporte digno aos brasileiros por meio de verbas governamentais e discursos de conscientização transmitidos pela mídia e outros meios de comunicação. Pois, nas palavras do ex-presidente da República, Michel Temer, “a economia pode ser retomada mas a vida não volta''.",200,160,120,160,160,800
5146,90,A Transfobia no Brasil,"Hoje em dia uma das questões que ainda é um tabu muito grande na nossa sociedade no geral, tanto no Brasil como no mundo mas principalmente na América Latina é a transfobia, onde pessoas do grupo LGBTQIA+ sofrem preconceito diariamente por causa das suas escolhas. Esses cidadãos pertencentes a tal grupo devem sim ter mais direitos e oportunidades em todas as áreas da sua vida, assim como também devem possuir direitos e tais direitos deverão ser respeitados pela sociedade brasileira.No Brasil a cada dia aumentam os números de pessoas transexuais e travestis e seguindo essa mesma linha aumenta também o número de violência e até mesmo assassinatos contra esses grupos específicos, sendo realizados por pessoas que não sabem respeitar os direitos e as escolhas de outro ser humano como ele. Empresas grandes como multinacionais deveriam começar a dar o exemplo de abrir vagas exclusivamente para pessoas que levam com elas a transexualidade, dando uma oportunidade a uma gama imensa do grupo LGBTQIA+ para ter um trabalho e uma oportunidade de vida melhor além de se sentirem representados nessas áreas. Mas acima de oportunidades deve vir o respeito aos direitos de todos, onde esse ambiente seja propício a uma pessoa trabalhar sem se sentir julgada, criticada ou desrespeitada pelos próprios colegas e seus respectivos superiores. Para que uma pessoa seja respeitada, observando a sociedade que foi, de uma certa forma, acostumada a julgar as escolhas do próximo, infelizmente não temos como desenvolver uma lei para exigir respeito, por dois motivos principais: o respeito deve vir da própria pessoa e o segundo motivo é que, infelizmente, se não houvesse uma punição grave essa lei com certeza não funcionaria.Conclui-se com isso que solução que devemos cogitar por mais que seja difícil conseguirmos, é que todos nós devemos aprender a respeitar as escolhas e principalmente o direito que essa pessoa tem de simplesmente ser quem ela quer ser, sem julgamentos, claro que não temos que obrigar as pessoas a gostar disso, mas a educação e o respeito sempre deve ser o mínimo a ser pedido, todos deveriam saber disso.",160,160,120,120,120,680
5226,90,uma solução para vida em sociedade,"A diferenciação dos grupos humanos faz parte da construção identitária dos indivíduos. No entanto, uma faceta perversa desse processo inerente da vida humana em sociedade inclui a violência de grupos dominantes contra minorias. A transfobia não é uma exceção a esse padrão histórico. Para lidar com esse problema, muitos defendem a tolerância como solução, porém tolerar não é o suficiente, é preciso entender e respeitar as diferenças.Misoginia, racismo e transfobia são apenas alguns termos que remetem à marginalização e à violência contra grupos minoritários com base em suas diferenças. Um exemplo disso é percebido quando a transfobia é cometida por integrantes de outros grupos LGBT+ , que mesmo sofrendo com a homofobia praticam os mesmo padrões de intolerância ao diferenciarem pessoas transgênero.A simples tolerância aos grupos minoritários não é suficiente para lidar com esse problema. Tolerar significa ignorar ou apenas permitir a existência do outro, enquanto o que as minorias precisam é de respeito e aceitação como parte integrante da sociedade. E para que isso possa ser possível, a solução mais adequada é pelo contato saudável entre os grupos. Entender a diferença é uma etapa para respeitá-la, mas só haverá compreensão de fato se houver espaço para o diálogo entre os grupos.Sendo assim, o Ministério da Educação é responsável por iniciar um padrão de maior respeito às diferenças a partir das escolas. Deve haver na educação dos jovens espaço para o diálogo sobre as diferenças. Pessoas transgênero, por exemplo, precisam de espaço de fala para desfazer falsas concepções e estereótipos a fim de melhorar a interação entre os diversos grupos da sociedade.",200,160,120,160,120,760
5260,91,A CIÊNCIA É FUNDAMENTAL,"A globalização- processo de expansão política e cultural- intensificou as relações de comunicação, bem como auxiliou no desenvolvimento tecnológico tornando a informação instantânea e próxima. No entanto, tal conjuntura encontra-se fragilizada, haja vista que o negacionismo científico se amplia na sociedade e os seus efeitos são alarmantes. Isso ocorre não só em razão da desinformação social, mas também de falhas no sistema educacional. Assim, é imprescindível a mudança dessa situação, o que pressupõe uma discussão.Diante desse cenário, apesar do avanço da tecnologia nem todos os indivíduos têm acesso à informação científica. Esse fenômeno é retratado pelo escritor Gilberto Dimenstein, em sua obra “Cidadãos de Papel”, no que tange a inefetividade dos direitos constitucionais, sobretudo, na desigualdade de oferta dos benefícios normativos. Nesse contexto, a ausência de notícias legítimas do campo científico que tenham fácil acesso para a população, principalmente, periférica contribui para o negacionismo. Consequentemente, a volta de enfermidades antes erradicadas e o uso de produtos sem nenhuma base científica, por exemplo, se tornam constantes. Dessa forma, é indispensável reverter esse panorama para que a informação verdade chegue aos lares brasileiros e a ciência seja exaltada.Outrossim, vale ressaltar que o modo como a educação é lecionada amplia pouco a área científica nas escolas. Sob esse viés, os colégios prezam mais por conteúdos técnicos em detrimento de um pensamento crítico proporcionada pela ciência, ou seja, debates sobre a profissão do cientista e os processos aplicados nesse ramo são fundamentais para evitar o negacionismo . Nesse sentido, o educador Paulo Freire defende que a educação é a porta para a mudança social e, sem ela, estaremos desamparados, o que revela a importância da escola como meio difusor de conhecimentos.Portanto, são necessárias medidas para mitigar e superar o impasse. Urge que Ministério da Ciência e Tecnologia, por meio de verbas governamentais, crie um site na internet e divulgue mensalmente projetos e estudos científicos em uma linguagem acessível para o corpo social, com o fito de democratizar a informação. Ademais, o Ministério da Educação deve realizar palestras no âmbito escolar, por intermédio de atividades pedagógicas com a participação de cientistas e professores de Biologia e Química, os quais dissertem acerca da relevância da ciência e sua utilidade, a fim de romper a barreira de negação dessa disciplina. Espera-se, com isso, a efetivação da globalização como propulsora de progresso junto à prosperidade de um legado social.",160,160,160,200,200,880
5263,91,A descrença da sociedade,"É fato que segundo a Constituição de 1998, cada cidadão brasileiro tem o direito de ter sua própria opinião sobre qualquer assunto, independente de censura ou licença; porém, o negacionismo científico, a ação de não acreditar em conceitos básicos da ciência, está ultrapassando a liberdade de expressão e causando danos severos a população. Diante deste quadro, é necessário analisar os fatores que o agravam.Primeiramente, é válido destacar que o principal efeito de uma população que não crê na ciência é o retorno de doenças já antes erradicadas no país, como é o caso da poliomielite, hepatite A, meningocócica C e outras enfermidades que não atingiram a meta de vacinação nos últimos anos e há muito tempo não tiravam a vida de tantos indivíduos como agora. É inadmissível que no Brasil, um lugar que já possui as vacinas, medicamentos e tratamentos dessas doenças, pessoas tenham que morrer por não acreditarem na ciência.Outro efeito que pode ser observado é que as verbas para universidades e centros de pesquisa são cortadas, já que para a população não é importante, também não será relevante para os governadores que escolherem. Lamentavelmente, com a falta de dinheiro para a educação, as informações falsas e o negacionismo científico só crescerão na sociedade brasileira.Desse modo, pode-se concluir que essa descrença irá apenas impedir o crescimento e desenvolvimento de milhares de vidas e da educação brasileira. Assim, o Ministério de Educação deve disponibilizar mais dinheiro para as universidades, centro de pesquisas e escolas com a finalidade de aumentar o espaço da ciência dentro do país, diminuindo então o negacionismo científico. Só assim, o Brasil poderá superar esse problema.",160,160,120,200,160,800
5282,91,"Brasil contra o retrocesso, o sofrimento e o risco.","Na ciência, o negacionismo é definido como a rejeição de conceitos básicos e incontestáveis, apoiados por consenso científico, em detrimento de ideias radicais e controversas. O maior exemplo disso na atualidade brasileira é o próprio presidente da nação negar a importância da vacinação frente a pandemia do covid-19, custando milhares de vidas. Diante desse contexto, é notório que o negacionismo científico causa prejuízos tanto a saúde quanto, ainda, a educação dos brasileiros.Quanto ao primeiro ponto, é importante perceber que o negacionismo científico está intimamente relacionado as fake news, ou seja, o compartilhamento de desinformação ou boatos através, principalmente, das redes sociais. Um reflexo disso está no fato de que, segundo o jornal Uol, no Brasil, o sarampo retornou em 2019 e a vacinação contra a poliomielite, que desde 1990 estava controlada, em 2016 não atingiu sua meta. Pois o movimento antivacina, que não possui nenhum embasamento, tem feito o índice de vacinação cair e doenças contagiosas erradicadas ou perto disso voltaram a aparecer. Observar um cenário como esse é avistar um quadro de retrocesso sofrimento e riscos.Ademais, é correto afirmar que a educação está sendo negligenciada pela ação do negacionismo científico. Uma vez que o Brasil tomou a decisão de fazer cortes inimagináveis em universidades federais responsáveis por pesquisas capazes de melhorar consideravelmente as condições de vida da população. A exemplo disso está a pele de tilápia usada no tratamento de queimaduras, desenvolvida na universidade federal do Ceará, mas que já é utilizada em outras partes do mundo. Logo, negar conhecimento é reconhecer a ignorância, a educação deve ser vista como um valor e a ciência como um recurso a ser explorado.A par das considerações feitas, cabe refletir sobre iniciativas capazes de combater o negacionismo científico no Brasil. Diante disso, o MEC - Ministério da Educação, órgão responsável pela legislação e regulamentação da educação no Brasil - deve adotar uma democracia direta, isto significada, uma organização na qual todos os cidadãos podem participar diretamente do processo de tomada de decisões. Isso dentro da sua capacidade de compreensão, desmistificando jargões científicos. Afinal, é natural que o desconhecido assuste, e uma decisão como essa significa estar ao lado do progresso e da educação, dito que o conhecimento não deve ser de propriedade apenas dos cientistas. Com essa finalidade, todos os brasileiros sentir-se-ão representados.",160,200,160,200,160,880
5323,91,Negacionismo científico,"O negacionismo, isto é, o não reconhecimento de um fato, pode ocorrer principalmente de duas maneiras: ao negar a seriedade de uma situação crítica e ao contestar a credibilidade das fontes tradicionais de conhecimento. Essas duas formas de negacionismo estão presentes na sociedade brasileira atual e geram consequências tanto para a gestão política e para a saúde pública quanto para a disseminação do conhecimento. Assim, importa analisar as causas e efeitos desse fenômeno que, em um contexto de pandemia, é fortemente alimentado ao mesmo tempo que torna-se um dos grandes obstáculos para a gestão pública.Primeiramente, é relevante perceber que o negacionismo costuma ascender na sociedade em momentos de crise, já que instituições tradicionais mostram-se insuficientes para solucionar os problemas mais urgentes. No entanto, hoje o negacionismo ganhou ainda mais força por causa das redes sociais. Os novos meios de comunicação da atualidade contribuíram para pôr os negacionistas em evidência e disseminar suas ideias. Consequentemente, “fake news”, que em outros contextos seriam ignoradas, são utilizadas para descredibilizar fundações científicas e governamentais usualmente consideradas fontes confiáveis de dados e conhecimentos. Além disso, a desinformação produzida pelas “fake news” coloca a saúde da população em risco ao divulgar tratamentos para doenças sem fundamentação científica e descredibilizar tratamentos factíveis e medidas de combate à disseminação de doenças, principalmente a covid-19.Da mesma forma, a vacina, principal estratégia de combate à pandemia, está sendo contestada pelos negacionistas. Mesmo antes da atual crise sanitária e independentemente do Brasil ser um dos poucos países com um sistema de saúde pública com calendário integrado de vacinação, casos de doenças, como o sarampo e a BCG, voltaram a crescer devido à diminuição na taxa de imunização. Esse fato é alavancado, principalmente, por pais que acreditam, sem fundamentação científica, que as vacinas possam ser prejudiciais para seus filhos.Paralelamente, no âmbito político, o negacionismo pode gerar uma formulação inadequada da gestão pública. Isso pode ser observado no governo negacionista do presidente mexicano López Obrador. Ao negar a gravidade da pandemia, esse governo não formulou uma política de combate à disseminação da covid de forma eficiente e em tempo ágil, como é necessário, nem tentou garantir um rápido fornecimento de vacinas para seus cidadãos. Assim, a morosidade no planejamento público gerou para o México o título de terceira nação com o maior número de mortes por covid-19.Posto isso, é de simples compreensão os efeitos que o negacionismo, tanto na esfera política quanto em relação à ciência, provoca para a sociedade. Assim, é de inegável relevância uma atuação conjunta do Ministério da Educação, pais e sociedade em geral para a promoção da educação, do combate à disseminação de “fake news”, além da promoção de políticas de transparência das instituições tradicionais de conhecimento para fortalecer a confiança depositada nelas e aproximá-las da sociedade.",160,160,160,200,160,840
5343,91,Os efeitos do ceticismo na sociedade brasileira,"O movimento antivacina surgido na segunda metade do ano de 2020 – época do desenvolvimento de várias vacinas contra o coronavírus- evidenciou o negacionismo científico enraizado na sociedade brasileira. Nesse contexto, pode-se destacar a valorização do senso comum como uma das principais causas para os efeitos irreparáveis que esse ceticismo pode ter na sociedade brasileira.Em primeira instância, é essencial destacar o culto ao senso comum – algo presente no pensamento coletivo, mas sem valor científico- como uma das principais causas para a desvalorização dos métodos científicos no Brasil. Sobre isso, pode-se mencionar uma notícia falsa que foi propagada em 1998, a qual consistia na ideia de que a vacina Tríplice viral – vacina contra o sarampo, a caxumba e a rubéola – provocava o autismo. Essa ideia, apesar de ter sido negada e comprovada cientificamente, ainda é tida como uma verdade irrefutável para parcela da população brasileira, o que demonstra a ignorância, a desinformação dos brasileiros acerca dos métodos baseados na ciência e prejudica o desenvolvimento da nação.Além disso, esse ceticismo exacerbado pode ter desdobramentos irreversíveis com o reaparecimento de doenças emergentes. A esse respeito, é imprescindível mencionar o reaparecimento do sarampo, em 2019, no Brasil devido, provavelmente, às notícias falsas que fizeram a população acreditar que a vacina Tríplice viral tinha como um dos efeitos colaterais o autismo. Esse fato demonstra as consequências negativas que o negacionismo científico pode ter na comunidade brasileira, já que o reaparecimento de doenças emergentes pode provocar uma crise no sistema de saúde.É necessário, portanto, que o Ministério da saúde, com o objetivo de esclarecer a importância da ciência, elabore campanhas – que terão a participação de cientistas e pesquisadores, os quais tentarão esclarecer o quão essencial são as práticas científicas para o desenvolvimento da nação brasileira – informativas . Essa proposta poderá ser divulgada por meio da mídia, especificamente, nas redes sociais, a exemplo de Facebook e Instagram, haja vista que têm um público mais amplo.",200,160,160,200,160,880
5383,92,*** Como combater o preconceito amarelo,"De acordo com a Constituição Cidadã, promulgada em 1988, todos são livres e iguais em dignidade e em direitos. Hoje, apesar de o respeito étnico fazer parte dos direitos sociais, a persistência do preconceito amarelo fere diretamente a Carta Magna, já que é evidente uma relação desigual entre a população asiática e as demais. Mediante a isso, cabe debater sobre formas de combatê-lo, além de suas causas, como a falta de denúncias e a má influência da mídia, a fim de cessar a realidade vigente.A priori, pode-se afirmar que a ausência de denúncias é um fator determinante à continuação do racismo em pauta. Para o filósofo Immanuel Kant, entretanto, o indivíduo deve agir conforme a máxima que deseja ser transformada em lei universal. Nesse sentido, tendo o Estado como único autor do processo judicial, as pessoas não deveriam ter receios em denunciar atos preconceituosos contra os asiáticos, a exemplo do que acontece ao sofrerem injúrias acerca do formato de seus olhos. Caso contrário, pois, o atual panorama que os sujeitos desejam alterar, dificilmente terá como combater. Assim, uma manutenção dos valores comportamentais da sociedade é um caminho redesenhador do tema em questão.Outrossim, o preconceito amarelo encontra terra fértil na negativa influência midiática ao silenciá-lo. Segundo o postulado bourdieusiano o que foi criado para ser instrumento da democracia não deve ser convertido em mecanismo de opressão. Nesse contexto, quando se invisibiliza a pré-existência do assunto, a mídia acaba naturalizando a sua prática cada vez mais. Pela falta de seu entendimento como sério comprometedor da democracia cívica, portanto, o racismo permanece sendo exercido sobre o povo asiático. Logo, esse mecanismo de opressão funciona como forte empecilho para resolução da problemática.Em suma, o preconceito amarelo está presente na contemporaneidade e necessita ser combatido. Para mudar esse quadro, o governo federal, juntamente com o Ministério das Comunicações, deve criar o projeto ''Não há cor para o preconceito'', destinado à sua população. Esse programa televisionário estará atrelado nas emissoras de televisão. Com o intuito de tornar o preconceito amarelho de conhecimento público, haverá apresentação de depoimentos próprios das vítimas sensibilizando o resto da nação a assumir uma postura de respeito à etnia. Feito isso, o preconceito contra os ascendentes da Ásia será derrotado, e o previsto da Constiuição de 1988 garantido.",160,200,160,200,160,880
5385,92,**Como combater o preconceito amarelo*,"Na Era Vargas, os japoneses e chineses eram representados de maneira estereotipada pelas revistas e charges da época, pois tais indivíduos eram considerados imigrantes indesejáveis. No Brasil atual isso não ocorre mais, porém, ainda é possível observar que o preconceito contra os amarelos continua presente na sociedade . Nesse contexto, percebe-se a configuração de um grave problema em virtude da lenta mudança de mentalidade e do silenciamento.Convém ressaltar, a princípio, que a lenta mudança de mentalidade é um fator determinante para a persistência do impasse. De acordo com Durkheim, o fato social é a maneira coletiva de agir e de pensar. Seguindo essa linha de raciocínio, nota-se que o racismo contra pessoas de origem ou ascendência asiática pode ser encaixado na teoria do sociólogo, uma vez que, se as pessoas crescem inseridas em um contexto social discriminatório, a tendência é adotar esse comportamento também. Assim, o fortalecimento do pensamento preconceituoso, transmitido de geração em geração, resulta numa sociedade cada vez mais xenofóbica em relação aos indivíduos que são amarelos.Além disso, outra dificuldade enfrentada é o silenciamento. Segundo o filósofo Habermas, a linguagem é uma verdadeira forma de ação. Dessa forma, para que um problema como o preconceito contra os amarelos seja resolvido, faz-se necessário debater sobre. Entretanto, percebe-se uma lacuna no que se refere a essa questão, que ainda é muito silenciada. Portanto, trazer à pauta esse tema e debatê-lo amplamente aumentaria a chance de atuação nele.Logo, medidas estratégicas são necessárias para alterar esse cenário. Para que isso ocorra o Ministério da Educação, juntamente com o Ministério da Mulher, da Família e dos Direitos Humanos, devem desenvolver palestras em escolas por meio de entrevistas com as vítimas do problema, bem como especialistas no assunto. Tais palestras devem ser webconferenciadas e divulgadas nas redes sociais dos ministérios, com o objetivo de alcançar um público maior e trazer mais lucidez sobre o preconceito amarelo. Assim, como propõe Habermas, encontraria-se um meio de solucionar a questão por meio do uso da linguagem.",160,200,160,200,200,920
5444,92,O preconceito como fruto da ignorância,"O preconceito contra asiáticos e seus descendentes sempre esteve presente em nossa sociedade. Porém com o advento da pandemia de Covid-19, esse preconceito tornou-se evidente e foi ampliado. Desta maneira, faz-se necessário que a sociedade como um todo tome medidas contra esse preconceito, que é apenas mais um, dentre as mazelas que afligem o povo brasileiro.A cultura de massa, teorizada pelos filósofos da escola de Frankfurt, é uma das fontes desse preconceito contra o diferente. Ela está sendo reproduzida de maneira exponencial, tornando tudo aquilo que é fora do padrão estabelecido, alvo de crimes de ódio. É através dessa padronização cultural, que surge o preconceito racial contra asiáticos, por eles não fazerem parte do padrão tido como ideal.Portanto, faz-se necessário, em primeiro lugar, que a família como um dos mais importantes pilares da nossa sociedade, atue no combate a essa intolerância, criando as suas crianças, futuros adultos, de maneira a não perpetuar esse preconceito, um dos piores males da nossa sociedade. Da mesma maneira, é de extrema importância, a escola ampliar a difusão dos ideiais de equidade e aceitação do diferente, através de palestras que visem acabar com a ignorância, que como William Hazllitt dizia, é a mãe do preconceito. Em última análise, a atuação do legislativo faz-se necessária, de maneira a tornar as leis mais severas, visando inibir de certa maneira, à prática do preconceito.",160,120,80,120,160,640
5469,92,Preconceito Amarelo,"O filósofo Sócrates afirmou que não era ateniense nem grego, mas sim um cidadão do mundo, demonstrando não discriminar indivíduos de diferentes origens. Contudo, ao se analisar as atitudes da maioria dos ocidentais frente as pessoas asiáticas, percebe-se uma aversão, distante do pensamento de Sócrates, a qual foi impulsionada pelo fato do Covid-19 - vírus que gerou uma crise na saúde global - ter surgido na China. Porém, cabe destacar que o preconceito amarelo não é algo recente, como a pandemia do novo coronavírus, já que ele já está consolidado nas nações ocidentais, sendo gerado pela desinformação a respeito dos povos asiáticos e intolerância instantânea a tudo que é considerado diferente.Primeiramente, é notório a existência de uma desinformação em massa sobre as culturas de procedência asiática, sendo esse aspecto nítido nas redes sociais. Segundo o filósofo Parmênides, o caminho do engano é aquele apoiado nas opiniões aceitas sem reflexão. Sob mesmo ângulo, a aceitação, sem questionamentos, de todas as informações, principalmente relacionadas aos hábitos alimentares asiáticos, disponibilizadas na internet gera uma aversão desfundamentada aos povos orientais. Logo, para se combater o preconceito amarelo, deve-se sanar a desinformação.Por outro lado, a intolerância a tudo que é considerado diferente também é responsável pelo preconceito amarelo. De acordo Arthur Schopenhauer, filósofo alemão, todo homem torna os limites do seu próprio campo de visão como os limites do mundo. Em consonância a essa ideia, a determinação de hábitos individuais como sendo corretos pode ser considerada responsável pela repulsão a tudo que se distingue desse padrão. Dessa maneira, a cultura oriental é tida, pelos ocidentais, como sendo estranha e errada, já que não abrange elementos considerados normais àqueles que não compartilham dos mesmos hábitos.Portanto, urge a necessidade de se combater o preconceito amarelo. Assim, o Ministério da Educação, cuja função é garantir um ensino de qualidade no Brasil, deve criar uma cartilha que desmistifique os preconceitos relacionados ao povo oriental, por meio do fornecimento de informações verídicas sobre a diversificada cultura existente no continente asiático, a fim de que ideias de cunho xenófobo deixem de fazer parte da sociedade brasileira. Além disso, tais cartilhas deverão atender não somente aos estudantes, mas também a toda população, que poderá acessá-las pelas redes sociais do Ministério da Educação. Destarte, todos passarão a defender que não são ocidentais nem orientais, mas sim cidadãos do mundo, em consonância ao que foi postulado por Sócrates.",200,200,160,200,200,960
5471,92,Preconceito Amarelo na Sociedade Brasileira,"O preconceito amarelo é uma discriminação, rejeição contra pessoas ascendentes de países asiáticos, que podem envolver tanto atos de agressões físicas, morais quanto psicológicas contra estes indivíduos. Diante disso, na realidade brasileira, esse comportamento é um sério problema para o país. Dentre tantos fatores relevantes temos: o alto índice de fake news no Brasil e o aumento da violência no país.Em primeiro plano, sabe-se que o crescimento de informações falsas é uma das causas da disseminação desse comportamento. Segundo o Presidente da República Jair Bolsonaro, a Covid-19 pode ter sido criada em um laboratório pelo país asiático como parte de uma bacteriológica. Na revista Nature Medicine, um estudo realizado por pesquisadores dos Estados Unidos, Austrália e Reino Unido comprovou que o novo coronavírus não foi criado em laboratório. A partir de uma análise, os cientistas encontraram evidências de que provavelmente o vírus seja resultado de seleção natural. “Nossas análises mostram claramente que não é uma construção de laboratório ou um vírus propositalmente manipulado”, afirmam os pesquisadores. Sendo assim, é preciso desacelerar o ritmo de fake news para que menos pessoas apoiem ou acreditem em notícias inverídicas.Ademais, o preconceito contra asiáticos é um problema que não para de crescer no país. Segundo dados do Centro de Estudos do Extremismo da Universidade Estadual da Califórnia, foram registradas quase 4.000 denúncias de violência e 8 casos de óbito nos Estados Unidos contra esses grupos. Nesse sentido, pelo artigo da Constituição federal de Lei n.º 7.716, é crime o ato de praticar, induzir e incitar a discriminação de raça, cor, etnia, religião e procedência nacional, que pode levar de um a três anos de reclusão e multa. Sendo assim, é crucial que maiores investimentos sejam feitos para que desacelere o nível de disseminação de ódio.Portanto, para efetivar a queda do preconceito amarelo no Brasil é necessário que o governo- órgão responsável pelos Três Poderes- promova Campanhas de Combate ao Preconceito em parceria com a mídia por meio de verbas governamentais, a fim de desacelerar o nível de vítimas de atos preconceituosos na sociedade. Só assim a intolerância que assola a realidade brasileira se extinguirá.",160,160,160,200,160,840
5482,92,"Preconceito, um mau oculto","No século passado, o mundo passava por diversas guerras e perseguições, uma delas foi o nazismo, movimento que perseguiu e matou cerca de 8 milhões de pessoas de origem judaica. Isso mostra que o preconceito contra pessoas de diferentes etnias é um problema recorrente na história da humanidade. Apesar de o Brasil ser um país bem mistificado, é comum relatos de vítimas que sofreram discriminações por conta de suas origens étnicas. Dessa forma, o combate ao preconceito amarelo é um desafio que precisa ser combatido com uma desculturação de pejorativos aos asiáticos, como também uma fiscalização dos meios virtuais.Convém ressaltar, a princípio, que a cultura de se criar apelidos aos povos de origens asiáticas é um fator determinante para permanência do preconceito, caracterizando-se como violência verbal. De acordo com as ideias do filósofo Jean-Paul Sartre, a violência seja ela física ou verbal, quando manifestada é uma derrota quando se há um mau a ser combatido. Nesse sentido, esses costumes de maus hábitos têm se tornado um empecilho para se combater o preconceito, visto que ele é um dos responsáveis pela disseminação de estigmas dos povos asiáticos.De mesmo modo, destaca-se o aparecimento de notícias falsas como uma das ferramentas usadas para caluniar certos países com divulgação de conteúdos falsos e até mesmo de ódio contra essas nações. Isto é, recentemente a China foi vítima de uma cancelamento virtual, na qual muitas pessoas publicaram inúmeras notícias inverídicas na internet que diziam que ela foi a responsável pelo aparecimento da covid-19, fato esse que provocou um aumento no número de crimes contra os chineses espalhados pelo mundo. Assim como a internet se tornou um ambiente para divulgação e debate sobre diversos assuntos, infelizmente tem sido usada também para propagação de “fake news” com o objetivo de cancelamento virtual de uma pessoa ou nação.Portanto, diante dos fatos supracitados, faz-se necessário que sejam tomadas ações para amenizar a questão. Logo, o Estado junto com os poderes legislativos e judiciais, por meio de criações de leis, ademais dos cumprimentos das que já estão em vigor, devem aumentar a fiscalização e fazer a justiça de forma mais ágil, para que assim diminua o compartilhamento de discursos de ódios, como também para as pessoa que infringem as leis respondam processos criminais. Além disso, as escolas devem formar cidadãos que respeitem as diferentes etnias. Em suma, é importante que sejam discutidos na aulas assuntos sobre as culturas de cada país, bem como o respeito a todos. Somente assim, esse preconceito será gradativamente erradicado, pois, conforme Gabriel O Pensador, “Na mudança do presente a gente molda o futuro”.",160,160,120,200,160,800
5485,92,Redação 2 - Preconceito Amarelo,"Durante o final do século XIX, foi impulsionado o movimento migratório de povos orientais para o Brasil. Nesse período, intelectuais brasileiros debatiam a suposta degradação racial que a relação entre nativos e asiáticos causaria, o que reflete discriminação racial. Este tipo de preconceito foi naturalizado no Brasil e, a partir disso, observa-se a necessidade de respeito a essa etnia que ainda sofre com estereotipagem e foi acusada de ser responsável pela atual pandemia de covid-19.Em primeiro lugar, ainda existem muitas demonstrações xenofóbicas enraizadas na sociedade brasileira. Comentários como “asiáticos são todos iguais” são frequentes, além dos padrões criados, e quando descendentes não atendem a esses estereótipos são menosprezados e inferiorizados. De acordo com o filósofo René Descartes, toda forma de preconceito e precipitação deve ser evitada em quaisquer análises e apenas deve ser considerado o que for indubitável e distinto, percebe-se então que tipificar asiáticos e seus descendentes os impede de demonstrar suas essências verdadeiras e individuais. Portanto, é necessário remover essas categorizações que inibem este grupo social e suas possibilidades de mostrarem-se únicos.Ainda convém lembrar que, a pandemia de covid-19 foi utilizada como pretexto para atitudes e discursos preconceituosos contra asiáticos. Segundo o site de notícias G1, em 2020 administradores tentaram segregar o acesso de trabalhadores de um escritório de uma empresa chinesa. Tal fato demonstra uma suposta acusação de que chineses estivessem espalhando o vírus propositalmente e que são os culpados por esta pandemia. Assim, a lei 7.716 que estabelece que praticar discriminação de raça ou etnia é passível de punição deveria ser cumprida mais assiduamente.Em suma, o preconceito amarelo deve ser combatido. Cabe ao governo federal cumprir a lei supracitada, monitorando perfis e acolhendo ocorrências de insultos xenofóbicos e punindo os autores conforme o Código Penal. Além de caber às escolas estimular a criação de eventos e atividades que exaltem a diversidade étnica, com a a finalidade de, através da educação, romper estereótipos em relação aos asiáticos, enraizados na sociedade brasileira. Para que, dessa maneira, equívocos disseminados há muitos anos a respeito do povo amarelo sejam, gradativamente, extintos.",160,160,160,200,160,840
5528,93,As responsabilidades na concepção de um indivíduo.,"O Código de Ética Médica, em seu capítulo V, expõe ser vedado ao médico desrespeitar o direito do paciente ou representante legal na escolha de práticas diagnósticas, ou terapêuticas, a não ser em casos de risco de morte eminente. Acerca do nascimento de um novo indivíduo, é indispensável que seja de maneira afável e humanizada, visando respeitar e cumprir com esse direito ao longo de todo o processo, mas principalmente no trabalho de parto.Quando se trata de saúde, é natural que haja a confiança nos profissionais, para que os mesmos ofereçam a melhor solução. Porém, cada indivíduo possui suas particularidades, e se tratando do ato de conceber um filho, é compreensível que existam medos, dúvidas e ignorâncias . Sendo assim, é responsabilidade do médico expor as possibilidades de tratamentos disponíveis, assim como esclarecê-los, proporcionando uma escolha mais consciente.Ainda convém lembrar que, não se trata apenas de ética, e sim de uma relação profissional primeiramente entre o Ministério da Saúde e seus funcionários, e em seguida, entre paciente e equipe hospitalar, sendo necessária a empatia, a confiança e o respeito. Dessa forma, o ambiente adequado, com equipamentos de qualidade e recursos básicos que supram o essencial, influencia diretamente no cumprimento de um bom trabalho.Portanto, para ser ofertado um acompanhamento, e principalmente um parto, mais humano, o qual respeite além do corpo, as preferências de cada mulher, deve haver um constante monitoramento, por parte das pacientes e/ou seus acompanhantes ao longo do tratamento, do cumprimento do direito de autonomia de escolha, garantido no Código de Ética Médica. Assim como, é de responsabilidade do Ministério da Saúde garantir aos seus funcionários os meios, como: equipamentos de qualidade, remuneração apropriada, e infraestrutura que possibilitem a execução de um trabalho adequado.",160,120,120,160,80,640
5626,93,,"O momento tão esperado para a mulher que está na espera de ver seu filho pela primeira vez, pode se tornar traumático. Tendo em vista sua condição, a mulher grávida espera o melhor atendimento, mas se frustra ao não ter seu corpo respeitado no momento do parto pelos profissionais que usam do tormento psicológico ao realizar o procedimento, tornando o parto estressante e podendo causar complicações. Há casos que vítimas desse abuso escolhem não ter o acompanhamento médico, movidas a insegurança e medo, se colocando em risco de vida.Primeiramente, o corpo do sexo feminino é historicamente vítima de invasões e a vontade da mulher é invalidada, deixando passagem livre para que os abusos no parto sejam banalizados e não enxergados como violação. Apesar de pouco falado do que deveria, no Brasil, a desumanização do parto se expressa nos dados, com partos cesáreas que exorbitam os 15% admitidos pela OMS , evidenciando que se trata de uma questão de saúde pública.Além disso, a presença da apelação de pressão psicológica por parte de médicos e enfermeiros suscitam traumas irreversíveis na autoestima dessa mulher, a levando optar por não querer o auxílio médico, podendo acarretar consequências fatais, antes mesmo do parto, para mãe e feto.Com o objetivo de mudar esse cenário, é imprescindível que se discuta a violência e a humanização do parto com os profissionais de saúde responsáveis pelo atendimento e haja a iniciativa do governo, em conjunto com as mídias sociais, agir através de campanhas informativas de conscientização dando voz às vítimas . Somente assim, garantindo sua integridade física e moral, que as mulheres se sentirão seguras e respeitadas.",160,120,120,120,80,600
5655,94,A inclusão na contemporaneidade,"Na Antiguidade Clássica, rejeitar e abandonar crianças portadoras de deficiências físicas ou transtornos mentais era uma prática comum entre os povos gregos e romanos. Atualmente, por mais que esse hábito hediondo tenha desaparecido e a vida dos indivíduos com condições especiais esteja sendo mais valorizada, milhares de autistas ainda enfrentam sérias dificuldades de inclusão social no Brasil. Nesse contexto, é importante analisar a desqualificação dos profissionais e o preconceito como principais aspectos motivadores dessa problemática.Convém ressaltar, a princípio, que a inexperiência, somada à falta de treinamento de muitos professores de Educação Especial, resultam na estagnação social e intelectual dos alunos. Segundo o filósofo Sêneca: “A educação exige os maiores cuidados, pois influi sobre toda a vida”. Nesse sentido, a capacitação de um corpo docente instruído e versado, capaz de assimilar as particularidades de cada sujeito, é indispensável ao desenvolvimento das capacidades cognitivas dos autistas. Tendo em vista os obstáculos na comunicação e interação social dessa parcela da sociedade, cabe aos orientadores auxiliarem e estimularem a socialização para com os colegas de classe, professores e funcionários.Além disso, a utilização do autismo como um adjetivo pejorativo cria concepções discriminatórias que comparam o transtorno a doenças mentais mais graves, como a demência. De acordo com o filósofo Diderot: “A ignorância não fica tão distante da verdade quanto o preconceito”. De maneira análoga, depreende-se que um dos problemas da inclusão não está pautado no desconhecimento dos brasileiros acerca do distúrbio, mas sim em noções equivocadas que, além de denegrirem a imagem dos autistas e levarem muitos deles ao isolamento social, suscitam a difusão de informações falsas sobre o transtorno.Portanto, diante o problema apresentado, faz-se inadiável a execução de medidas estratégicas capazes de promover a integração desses indivíduos na sociedade. Para tal, é papel do Ministério da Educação – órgão responsável pelas políticas educacionais – providenciar a qualificação dos profissionais da Educação Especial e elucidar o conceito de autismo, por meio de palestras e seminários webconferenciados para alunos e professores, a fim de que haja pleno desenvolvimento individual dos autistas e maior compreensão a respeito de todos os fatores que envolvem o distúrbio. Somente assim, ampliando a educação, será possível contrariar a moral greco-romana e valorizar toda e qualquer vida.",160,200,160,200,200,920
5681,94,Autismo,"Inclusão social vai muito além de colocar pessoas com diferentes necessidades para participar de atividades conjuntamente. É também necessário que o meio onde indivíduos especiais serão inseridos esteja preparado para recebê-los. Nesse sentido, no que concerne ao autismo, poucas escolas possuem a devida estrutura. Além disso, a sociedade brasileira ainda carece de informações e entendimento acerca do tema.Primeiramente, boa parte das escolas ainda é um ambiente hostil não só para crianças com autismo, mas para qualquer uma que fuja aos padrões da maioria. No caso do autismo, a situação fica ainda mais delicada pois faltam profissionais e educadores capacitados para lidar com esses indivíduos. Assim, faz-se necessário que as instituições educacionais forneçam programas de capacitação aos seus professores acerca do tema, ou que contratem um número mínimo de profissionais especializados para atuar em conjunto com os educadores.Ademais, a falta de conhecimento e familiaridade por parte da população também se reflete nas dificuldades para a inclusão. Muitas vezes as peculiaridades de um autista são vistas, pejorativamente, como meras frescuras . É preciso que a população entenda que esses problemas, independentemente da intensidade, decorrem de um quadro patológico, que precisa ser analisado sob uma ótica mais sensível e empática. Além disso, é imprescindível que os pais estejam envolvidos com o cotidiano escolar dos filhos, e os conscientizem sobre as necessidades especiais de cada um, de modo a evitar casos de bullying e discriminação.Portanto, cabe a órgãos como o Ministério da Educação, responsável pelo sistema educacional nacional, instituir programas que visem aperfeiçoar a estrutura das instituições públicas e privadas para lidar com tais questões. Somado a isso, é importante que agentes midiáticos como emissoras de TV aberta e sites de notícias continuem ampliando o debate acerca do autismo, para que a população entenda a importância dessa questão na busca por uma sociedade mais humanitária e equânime.",160,160,120,200,120,760
5795,101,Brasil do Cristo Redentor e das facções criminosas,"Na última década, a questão da criminalidade passou a ser considerado um problema e um desafio para o Brasil. À guerra entre facções criminosas ganhou enorme visibilidade pública e jamais em nossa história recente esteve tão presente nos debates entre autoridades de segurança e do público em geral.O primeiro ponto a ser discutido é: O tratamento que o crime organizado e extremamente inteligente tem tido pelas autoridades policiais. Com estatísticas alarmantes de vítimas da criminalidade, comparado com países como o Oriente médio, por exemplo, no qual vive em constante guerra, o Brasil supera literalmente essa marca. Vale lembrar, ainda, que essas sucessivas mortes de policiais no estado de São Paulo , é apenas o estopim de uma bomba complexa que já explodiu, propagando uma completa desordem, gerando cada vez mais a insegurança nas metrópoles.Outro ponto de vista, também relevante, seria: A mudança repentina e inviável, da noite para o dia, de uma instituição praticamente falida. Policiais são mal treinados, mal remunerados, o armamento é insuficiente e defasado em relação à alta tecnologia usada pelos criminosos e, além também, da morosidade da justiça, quando aparelhos do judiciário não dão uma resposta a altura , à consequência é a sensação de impunidade que é passada para a população. Vale lembrar, ainda, que a redução da criminalidade não é tão simples como se pensa, são necessárias ações preventivas, mudanças estruturais, como leis, medidas sócio-educativas e engajamento da sociedade.Sendo assim, autoridades estão partindo para uma solução imediatista e não atacando de fato o problema pela raiz. As mudanças são mais do que necessárias, mas isso a longo prazo. Encarcerar quando realmente for necessário, aplicando mais penas alternativas, e uma polícia que não utilize o extermínio como forma de punição, já é um grande recomeço para uma estrutura de segurança com mais solidez. Pois, é somente em dozes homeopáticas que se conseguirá notar mudanças positivas como um todo.",160,160,160,120,120,720
5861,104,Transform(ação),"Carros. Motos . Ônibus. Caminhões. É inegável o alto número de veículos de grande porte nas ruas atualmente. Esses são alguns exemplos de meios de transporte que são responsáveis pelo trânsito desordenado do dia a dia. Alguns pontos importantes devem ser elucidados, tendo por objetivo propor soluções, respeitando da melhor maneira cada indivíduo.Segundo a pesquisa Datafolha, cerca de 80% dos paulistanos concordam com a implantação das ciclovias, e 60% acreditam que a bicicleta é um meio de transporte viável para o dia a dia. Mas apesar disso, apenas 3% usam a bicicleta com frequência. Faz-se necessário, portanto, de uma maior incentivação .Por outro lado, não há segurança para os ciclistas no trânsito caótico do dia a dia. Embora pareça impossível buscar as soluções para o problema, é fundamental agir para reduzir ainda mais seus efeitos. Para isso, precisamos sair deste estado de inércia.É de extrema importância criar ciclofaixas para que os ciclistas tenham uma maior segurança. Além da circulação de campanhas em todos tipos de mídia, assumindo, assim, o compromisso pelo compartilhamento da importância do respeito aos que usam a bicicleta como meio transporte. Soluções imediatas, portanto, são importantes . No entanto, para completar essa equação, é preciso investir na verdadeira transformação. Nesse sentido, o governo deveria investir mais em ciclofaixas e aplicar multas à quem desrespeita o espaço dos ciclistas, como motoristas de carro . ONGs também poderiam ensinar e fiscalizar a população.Torna-se evidente, portanto, que as ciclovias são muito importantes, uma vez que as bicicletas além de não poluírem, também contribuem para um melhor trânsito. Já é tempo de políticos agirem e o povo entender a importância da sua contribuição.",120,120,80,80,120,520
5993,114,A violência nas escolas,"Uma situação que vem se agravando, e se multiplicando, cada vez mais, é a violência ocorrente nas escolas. Isso de fato, não pode ser dispensado ou deixado de lado, devemos fazer algo para mudar essa situação.Membros do núcleo gestor das escolas, tentam fazer o possível para diminuir o ocorrido e acabam não obtendo exito nas sua tentativas, isso significa que não estão achando as soluções certas, para resolver esse problema.Nos últimos anos, nós é mostrado muitas ocorrências envolvendo esse tema, muitos jovens sofrem agressões, tanto física como verbal. Pode servir como exemplo, um caso ocorrido no Rio de Janeiro, em que um ex-aluno, no dia 7 de abril de 2011, entrou numa escola, e praticou um massacre matando vários alunos de lá.Fora isso, também, o enorme número de brigas ocorrentes nas escolas, que são gravadas por outro alunos, e postas nas redes sociais, como uma forma de expor algo divertido, e legal aos outros.Algo que deve ser ressaltado, é a, importância da presença dos pais no processo de mudanças nesses casos, sem a cooperação dos pais, não é possível mudar essa realidade. Devemos nós aprofundar e estabelecer um compromisso de ambos os lados , para a melhor comunicação com os alunos e assim, saber o que esta acontecendo em sua vida, os problemas, as dúvidas, achando assim uma forma de ajudar esse aluno.Para que assim, alunos, pais e membros da direção possam entrar num acordo entre si, levando aos alunos, não precisarem praticar algo para se aliviar, e se sentir melhor, como a violência com os demais.",120,120,80,80,80,480
6327,134,Transform(ação),"Carros. Motos . Ônibus. Caminhões. É inegável o alto número de veículos de grande porte nas ruas atualmente. Esses são alguns exemplos de meios de transporte que são responsáveis pelo trânsito desordenado do dia a dia. Alguns pontos importantes devem ser elucidados, tendo por objetivo propor soluções, respeitando da melhor maneira cada indivíduo.Segundo a pesquisa Datafolha, cerca de 80% dos paulistanos concordam com a implantação das ciclovias, e 60% acreditam que a bicicleta é um meio de transporte viável para o dia a dia. Mas apesar disso, apenas 3% usam a bicicleta com frequência. Faz-se necessário, portanto, de uma maior incentivação .Por outro lado, não há segurança para os ciclistas no trânsito caótico do dia a dia. Embora pareça impossível buscar as soluções para o problema, é fundamental agir para reduzir ainda mais seus efeitos. Para isso, precisamos sair deste estado de inércia.É de extrema importância criar ciclofaixas para que os ciclistas tenham uma maior segurança. Além da circulação de campanhas em todos tipos de mídia, assumindo, assim, o compromisso pelo compartilhamento da importância do respeito aos que usam a bicicleta como meio transporte. Soluções imediatas, portanto, são importantes . No entanto, para completar essa equação, é preciso investir na verdadeira transformação. Nesse sentido, o governo deveria investir mais em ciclofaixas e aplicar multas à quem desrespeita o espaço dos ciclistas, como motoristas de carro . ONGs também poderiam ensinar e fiscalizar a população.Torna-se evidente, portanto, que as ciclovias são muito importantes, uma vez que as bicicletas além de não poluírem, também contribuem para um melhor trânsito. Já é tempo de políticos agirem e o povo entender a importância da sua contribuição.",120,120,80,80,120,520
6391,139,Brasil do Cristo Redentor e das facções criminosas,"Na última década, a questão da criminalidade passou a ser considerado um problema e um desafio para o Brasil. À guerra entre facções criminosas ganhou enorme visibilidade pública e jamais em nossa história recente esteve tão presente nos debates entre autoridades de segurança e do público em geral.O primeiro ponto a ser discutido é: O tratamento que o crime organizado e extremamente inteligente tem tido pelas autoridades policiais. Com estatísticas alarmantes de vítimas da criminalidade, comparado com países como o Oriente médio, por exemplo, no qual vive em constante guerra, o Brasil supera literalmente essa marca. Vale lembrar, ainda, que essas sucessivas mortes de policiais no estado de São Paulo , é apenas o estopim de uma bomba complexa que já explodiu, propagando uma completa desordem, gerando cada vez mais a insegurança nas metrópoles.Outro ponto de vista, também relevante, seria: A mudança repentina e inviável, da noite para o dia, de uma instituição praticamente falida. Policiais são mal treinados, mal remunerados, o armamento é insuficiente e defasado em relação à alta tecnologia usada pelos criminosos e, além também, da morosidade da justiça, quando aparelhos do judiciário não dão uma resposta a altura , à consequência é a sensação de impunidade que é passada para a população. Vale lembrar, ainda, que a redução da criminalidade não é tão simples como se pensa, são necessárias ações preventivas, mudanças estruturais, como leis, medidas sócio-educativas e engajamento da sociedade.Sendo assim, autoridades estão partindo para uma solução imediatista e não atacando de fato o problema pela raiz. As mudanças são mais do que necessárias, mas isso a longo prazo. Encarcerar quando realmente for necessário, aplicando mais penas alternativas, e uma polícia que não utilize o extermínio como forma de punição, já é um grande recomeço para uma estrutura de segurança com mais solidez. Pois, é somente em dozes homeopáticas que se conseguirá notar mudanças positivas como um todo.",160,160,160,120,120,720
6562,150,A violência nas escolas,"Uma situação que vem se agravando, e se multiplicando, cada vez mais, é a violência ocorrente nas escolas. Isso de fato, não pode ser dispensado ou deixado de lado, devemos fazer algo para mudar essa situação.Membros do núcleo gestor das escolas, tentam fazer o possível para diminuir o ocorrido e acabam não obtendo exito nas sua tentativas, isso significa que não estão achando as soluções certas, para resolver esse problema.Nos últimos anos, nós é mostrado muitas ocorrências envolvendo esse tema, muitos jovens sofrem agressões, tanto física como verbal. Pode servir como exemplo, um caso ocorrido no Rio de Janeiro, em que um ex-aluno, no dia 7 de abril de 2011, entrou numa escola, e praticou um massacre matando vários alunos de lá.Fora isso, também, o enorme número de brigas ocorrentes nas escolas, que são gravadas por outro alunos, e postas nas redes sociais, como uma forma de expor algo divertido, e legal aos outros.Algo que deve ser ressaltado, é a, importância da presença dos pais no processo de mudanças nesses casos, sem a cooperação dos pais, não é possível mudar essa realidade. Devemos nós aprofundar e estabelecer um compromisso de ambos os lados , para a melhor comunicação com os alunos e assim, saber o que esta acontecendo em sua vida, os problemas, as dúvidas, achando assim uma forma de ajudar esse aluno.Para que assim, alunos, pais e membros da direção possam entrar num acordo entre si, levando aos alunos, não precisarem praticar algo para se aliviar, e se sentir melhor, como a violência com os demais.",120,120,80,80,80,480
6591,151,A Cultura da Erotização Infantil ,"A cultura da erotização infantil é um problema que está cada vez mais presente na sociedade, via momentos não são percebidos pelos adultos, como cenas sensuais de novelas, séries ou filmes, letras de músicas que depreciam e vulgarizam o ato sexual ou algum gênero específico, principalmente o feminino, que estimulam comportamentos e pensamentos impróprios para crianças. São situações que merecem a devida atenção dos pais ou responsáveis para que sejam evitados transtornos futuros para si mesmos e para a prole.Séries, filmes e novelas são produtos de entretenimento consumidos por todas as idades e perfis. Essas produções têm classificações etárias, que nem sempre são respeitadas, por conta principalmente da negligência familiar. Nesse cenário, as crianças têm acesso amplo a conteúdos com forte apelo erótico, que de alguma maneira os inspiram a reproduzirem certos comportamentos que não condizem com a idade que possuem, sendo manifestado na vestimenta ou na forma de falar, por exemplo. A família deve monitorar o que os filhos assistem para evitar que esse tipo de situação ocorra em suas casas, prevenindo danos para o desenvolvimento físico e mental da criança.Letras musicais são outra maneira de fomentar a cultura da erotização infantil, em que muitas delas depreciam e vulgarizam o sexo e um gênero, sobretudo feminino, utilizado palavras de baixo calão em alguns casos. São composições que podem introjetar na mentalidade das crianças comportamentos de cunho machista e misógino que hipersexualizam o corpo humano, principalmente de mulheres, que podem prejudicar na forma com que elas, na fase adulta, se relacionarão com o sexo oposto. Novamente, é preciso que os pais monitorem as músicas escutadas pelos seus filhos e dialoguem com eles, de forma a desconstruir qualquer pensamento negativo oriundo de tais composições musicais.Um caminho que pode ser adotado na luta contra a cultura da erotização infantil pelo governo são campanhas publicitárias voltadas para as famílias das crianças que conscientizem elas da importância do monitoramento do conteúdo consumido por seus filhos, de forma que estimulem esses familiares a serem mais atuantes na vida das crianças, evitando que esse processo continue a estimular a adoção inconsciente de comportamentos inapropriados para determinadas faixas etárias.A cultura da erotização infantil é um problema recorrente na sociedade atual, sendo fomentadas através de alguns momentos que passam despercebidos dos adultos, como cenas sensuais de novelas, séries ou filmes, letras de músicas que depreciam e vulgarizam o ato sexual ou algum gênero específico, principalmente o feminino. É um problema que tem solução, basta o governo auxiliar os pais a tomarem consciência da importância deles na vida dos seus filhos.",160,160,120,120,120,680
6603,151,A EROTIZAÇÃO PREMATURA (VI) ,"A erotização infantil se caracteriza pela exposição a conteúdos e situações que incitam a sexualidade prematura. O que tem se tornado mais comum, devido as opções para a propagação desse tipo de conteúdo. As mídias sociais e brincadeiras entre familiares com conotações sexuais, resultam na proximidade da petiz com a voluptuosidade.O contato com esses conteúdos impróprios impulsionam a sua curiosidade. Tendo por conseguinte a perda de sua puerícia, que acaba replicando a sexualidade que lhe foi apresentada em seu cotidiano, como brincadeiras e gestos. Tornando as crianças mais vulneráveis á violência e ao abuso sexual.Assim a prevenção é a melhor medida. Sobretudo é importante deixar as crianças se desenvolverem em um ritmo saudável e próprio. Com cuidados e supervisões de seus responsáveis em relação as mídias sociais, dispositivos eletrônicos e orientações sobre atividades adequadas à idade, assim como a comunicação com os pais. Destarte as crianças são introduzidas a sexualidade de forma natural e no tempo adequado.",160,120,120,120,120,640
6621,151,As mídias e a erotização infantil ,"Em virtude do cenário atual a erotização infantil é um assunto que causa cada vez mais preocupação em especialistas e pesquisadores. E com a chegada das mídias sociais esta questão vem se agravando evidentemente.O amadurecimento precoce de crianças causa a distorção de fases essenciais do desenvolvimento humano, como a diminuição da infância, prejudicando, além do crescimento físico e psicológico destas crianças, as relações com seus responsáveis, por isso este impasse vem atraindo olhares dos mais diferentes especialistas, como a psicopedagoga e psicopatóloga Iane Cruz Obando, que afirma ser necessário aprofundar o tema para compreender mais concretamente suas causas.O fácil e rápido acesso de crianças às mais diversas mídias, como televisão, redes sociais, propagandas, sites e filmes, que possuem conteúdos prematuros às suas idades, tornaram a indução de crianças a determinados comportamentos não propícios a sua condição de criança, muito mais frequentes e perigosos. Por exemplo, o TikTok, mídia que fez muito sucesso no período de quarentena entre pessoas das mais diversas idades, foi uma explosão de erotização infantil, onde a exposição da sexualização precoce de crianças ficou evidente.Em vista disso, é dever do Ministério Público Federal fiscalizar o cumprimento do artigo 227 da Constituição federal de 1988 e dos artigos 75, 240 e 241 do Estatuto da Criança e do Adolescente, leis responsáveis por garantir a segurança e o bem-estar da população brasileira e, no caso específico do Estatuto da Criança e do Adolescente, dos brasileiros menores de 18 anos. Esta ação deve ser realizada por intermédio de averiguações mais rápidas e eficazes de representações, com o intuito de que haja punição aos responsáveis pela publicação e difamação de conteúdos causadores de erotização infantil.",200,160,120,160,160,800
6622,151,Combate a erotização infantil ,"Atualmente as crianças e adolescentes estão se desenvolvendo muito cedo, e se vulgarizando com roupas curtas e decotadas, maquiagens muito pesadas para suas idades, ao invés de curtirem e aproveitarem suas infâncias e respectivas idades.Isso acontece pois as crianças e adolescentes não estão tendo a devida educação para entenderem a situação a que estão sendo expostas. Alguns pais não conversam com seus filhos sobre suas sexualidades e outros até incentivam sua adultização muito cedo por acharem bonito ou algo bastante atual nos dias de hoje, incentivando assim a erotização sexual. A sexualidade é muito normal desde que seja em seu devido tempo.As escolas também não fazem seu papel, em razão de que a escola é um lugar de aprendizado e não existe nenhuma aula de educação sexual nas escolas brasileiras que ensinem os alunos de forma apropriada e de maneira correta.Portanto o governo deve impor nas escolas aulas sobre educação sexual, criar projetos e campanhas que ensinem as crianças e os adolescentes, e os pais devem conversar com seus filhos e ensinar sobre suas sexualidades.",200,120,120,120,120,680
6638,151,Distopia Infantil ,"Em um episódio da série “ Black Mirror” , da streaming Netflix, é abordado um contexto da sexualidade infantil, no qual um jovem realiza atos libidinosos ao visualizar fotos de crianças na internet. Logo, faz-se necessário a análise desse pressuposto no contexto atual . A partir do momento em que , no Brasil, há alta taxas de casos de erotização de crianças. Sendo assim, entende-se que a valorização da sexualidade em menores no dia a dia e o uso das redes de comunicação para esse fim inferem como precursor da problemática.Em primazia, atos comuns envolvendo a sexualidade infantil servem como uma das prerrogativas desse percalço. Logo, comumente usados, os termos “Novinha/Novinho” servem para designar a preferência sexual aos menores de dezoito anos na sociedade. Apesar de que muitas vezes usados sem a intenção, há a compreensão de que esses termos tem raízes no fenômeno da erotização de menores. No entanto, os efeitos dessa cultura tem consequências horríveis , a partir do momento que compromete a vida de jovens e crianças, que no final são abusadas e vistas como objetos de desejo e consumo de maiores, tirando delas sua inocência e colocando em risco o proveito de parte de suas vidas responsáveis pela juventude e infância. Desse modo, compreende-se a gravidade do problema em questão.Outrossim, o amplo acesso ao mundo virtual para fins de erotização e abuso infantil contribui para a problemática. Dessa forma, o que espera-se dos meios de informação é nada mais que uma aliança em prol da luta contra a cultura da valorização da sexualidade infantil, entretanto colocam-se como portas abertas para a ocorrência dessa distopia. Entende-se isso a partir do momento em que a existência de revistas como a “Playboy”, de sites pornográficos como o “XVídeos” ou fóruns de encontros sexuais contribuem para a procura de menores a fim da ocorrência de abusos e assédios movidos pela valorização de suas sexualidades. Com isso, há a reflexão do quanto o ambiente digital , local de fácil busca de dados e manipulação de informações , propicia para atos criminosos contra crianças. Dessa maneira , faz-se mister o quanto o mau uso das redes maximiza o desafio.Em suma, é preciso soluções para os problemas vigentes. Portanto, é dever do Ministério da Cidadania, por meio do Ministério das Comunicações, criar uma campanha de conscientização sobre a exposição sexual de crianças na sociedade, com o auxílio das próprias mídias digitais e sociais , ocorrendo de forma a inibir também a atuação de sites pornográficos ou abuso e assédio aos menores no meio digital, a fim de que os casos de erotização sejam diminuídos e que a sociedade entenda a importância da resolução desse problema. Em síntese, acontecimentos como o descrito na série “ Black Mirror” não serão mais o reflexo da sociedade brasileira.",160,160,160,200,160,840
6639,151,Educação sexual x sexualização ,"Durante a Idade Média os corpos infantis eram retratados nos quadros como adultos em miniatura, pois naquela época a infância era pouco valorizada e vista apenas, como uma passagem do nascimento para a vida adulta. Atualmente, há diversos estudos referentes ao mundo infantil. Com isso, as crianças possuem a liberdade de serem quem são e aproveitarem essa fase de maneira lúdica e curiosa. Por outro lado, essa mesma liberdade tem trazido conflitos e despertado a sexualidade precoce delas, o que pode causar um aceleramento para a vida adulta e desencadear transtornos psicológicos no futuro. Além disso, com a exposição em rede, consequentemente pode abrir espaços para pedófilos.Contudo, as crianças devem ser orientadas a evitarem a exposição excessiva nas redes sociais, pois através da aceleração de informações proporcionadas pela tecnologia, muitos pedófilos tem se aproveitado disso para cometer seus crimes . Sendo assim, os pais devem acompanhar os filhos em suas comunicações em redes para a proteção da infância. No entanto, referente a sexualidade infantil, é de suma importância a família tratar esses assuntos para o desenvolvimento e educação sexual, o que pode evitar possíveis abusos sexuais e até mesmo assédios no mundo virtual.Por outro lado, muitos pais involuntariamente acabam envolvendo as crianças demais nesse ambiente de sexualização dos corpos, eles não ensinam a educação sexual e sim, a erotização infantil por meio de conteúdos de filmes, novelas e músicas, e até mesmo cenas do dia a dia, a infância vai sendo tomada por essa sexualidade adulta, através de palavras, gestos, danças e atitudes inapropriadas para a idade delas . Isso pode levar a adultização e desencadear sérios problemas no que se refere a vida sexual precoce, e até mesmo a gravidez na adolescência.Portanto, no que tange a educação sexual, as escolas devem proporcionar orientações por meio de reuniões de pais, alertando-os sobre os possíveis problemas gerados para seus filhos em relação a interferência de incentivo a sexualidade adulta na sexualidade infantil. No mais, as instituições de ensino deverão desenvolver junto ao seu corpo docentes, atividades elaboradas para trabalhar assuntos atuais sobre a sexualização infantil, por meio da educação sexual.",160,160,160,200,160,840
6641,151,Erotização infantil ,"O filme Cuties, lançado pela empresa de entretenimento Netflix, levantou um grande público enfurecido, o qual alegava que tal obra cinematográfica expunha atrizes, de até 14 anos, de uma maneira muito vulgar, com roupas sensuais e posições eróticas. Justificativas como “Ah, mas o filme não foi feito para o público infantil” foram utilizadas por muitos como uma tentativa de defesa a longa-metragem. Por outro lado, é questionável o porquê dos protagonistas do elenco serem crianças se o filme, a princípio, seria direcionado ao público adulto.A fase da infância possui uma grande relevância na formação individual, tendo que disputar lugar com a sexualidade precoce, influenciada por meios externos, como conteúdos infantis recheados de conotações sexuais ou trazidas por pessoas pertencentes ao ciclo de convivência e confiança da criança, fazendo com que atitudes adultas sejam alvo de busca dos pequenos, como a utilização de uma roupa mais sensual, por exemplo.A extrema erotização infantil nas mídias abre largas portas à pedofilia, desencadeando uma rede de crimes sexuais cometidos com crianças. Parafraseando o comentário da neuropsicóloga Deborah Moss à revista MdeMulher, é possível reafirmar a importância da fase infantil na vida dos indivíduos, e o perigo que pular etapas pode trazer a formação dos mesmos, sendo necessária uma onda de conscientização advinda da tríade Estado, escola e mídia.Diante dos fatos apresentados, fica evidente a urgência de medidas visando a proteção dos pequenos, direito assegurado constitucionalmente. O Estado, com seus três poderes, poderia colocar em prática as leis protecionais já existentes. A escola, como instituição educadora, completaria a missão fazendo campanhas de conscientização com crianças e pais, como conversas interativas com psicólogos e profissionais da comunicação. A mídia por sua vez, como quarto poder, seria responsável por realizar campanhas pontuando os perigos da erotização infantil e derrubar páginas e sites onde há o incentivo à sexualização precoce.",200,160,120,120,160,760
6678,151,"Pequenos em Tamanho, Grandes em Problemas ","Em um mundo globalizado e dinamicamente tecnológico como a sociedade encontra-se, não é incomum perceber a participação serôdia das pequenas faixas etárias ao universo da internet, já que desde a mais tenra idade a criança é submetida a ele. No entanto, tal aproximação não produz somente qualidades, mas também grandes problemas à formação do indivíduo, como é o caso da erotização precoce.Ainda em estágio de amadurecimento, esta população é desprovida de certos discernimentos; e o fácil acesso a conteúdos sexualmente explícitos, principalmente nos meios digitais, atrelados ao desejo pessoal de conhecer seu próprio corpo, os faz querer compreender o processo sexual sem ter as qualificações necessárias para tanto, tornando-os vítimas de uma alienação sem limites, sendo influenciados por terceiros no modo de pensar, agir, vestir, entre outros, colocando em risco a boa conduta na sociedade na qual serão futuramente inseridos. Consoante a isto, o processo de maturidade mental, social e psíquica da juventude é antecipado, causando uma adesão rápida ao mundo adulto que traz altos malefícios para todos.A mídia e as redes sociais são as maiores influenciadoras neste processo, pois a erotização infantil é constantemente utilizada por sites e até mesmo pelo mercado de filmes como objeto de venda. Contudo, outros fatores podem ser creditados a esta prática, como a negligência dos pais, da escola e demais grupos sociais no que tange a correta educação sexual de menores e a falta de atenção dos mesmos no comportamento digital das crianças.Portanto, é necessária a participação efetiva do governo, das autoridades educacionais e médicas e das famílias na criação de uma ação de combate nacional, divulgada na internet, nas escolas e nos estabelecimentos de saúde que proporcione uma educação sexual sadia, por meio de palestras e vídeos com professores e especialistas, ensinando critérios corretos de corpo e mente, para que a infância possa ter à sua disposição uma fonte segura de ensino. A maior rigidez no controle e fiscalização de sites e outros meios de comunicação que pratiquem a erotização também seria uma forte impulsionadora para corroborar com a extinção desta prática no espaço virtual e social, levando os responsáveis à justiça. Com isso, compreendemos que este mal será, em pouco tempo, diminuído e praticamente inexistente no país, para que as crianças do presente proporcionem adultos conscientes do futuro.",200,160,160,120,160,800
6682,151,Sexualização infantil ,"Não é novidade que com a chegada da internet e o mundo das mídias sociais as pessoas estão expondo cada vez mais suas vidas online, uma das formas de exposição mais sensíveis que há é envolvendo crianças.Atualmente é cada vez mais comum observar crianças com um comportamento impróprio para sua idade, em alguns lugares vira um requisito, como se fosse necessário tal adultização, elas que muitas vezes influenciadas pela mídia desejam aparentar e agir como se fossem mais velhas tentam pular fases essenciais da vida para seu crescimento, se mostram de forma sexualizada tanto online quanto em seu cotidiano. De forma geral, apresentam aspectos não saudáveis que não condizem com a sua idade, coisa que é prejudicial para a criança e poderá afetar seu desenvolvimento futuro, a infância é uma parte crucial da vida de qualquer pessoa e jamais deve ser negligenciada.No entanto é de suma importância que os pais fiquem atentos e não tentem incentivar tal comportamento em seus filhos, procurem supervisionar os conteúdos consumidos pelos pequenos e manter hábitos condizentes com a idade da criança.",160,120,120,120,120,640
6688,151,Um dever dos adultos com as crianças ,"A erotização de mulheres é muito comum, o que é um grave problema no mundo, mas um problema ainda mais grave quando essa erotização começa na infância e adolescência, de acordo com o Psicanalista Freud é onde se é desenvolvido o caráter, afeições e construções psicológicas para um adulto emocionalmente e psicologicamente saudável.No livro Lolita de Vladimir Nabokov, é nos apresentado um homem que está interessado em uma menina de 12 anos de idade, onde ele relata os desejos e paixões pela jovem, a crítica da obra para algumas pessoas seria muito simples, considerar a paixão de um adulto por uma criança é errado e crime, porém surgem outras interpretações da obra.Esse fato nos faz refletir em como a criança sofre objetificação, e a forma como o narrador descreve-a traz essa erotização do corpo infantil, o livro apesar de ser de 1955 é muito atual, pois, ainda hoje é possível acessar em redes sociais, posts feitos em sua maioria por homens, comentando em fotos com tom sexual, pejorativo e em alguns casos acediosos de meninas muitas vezes menores de idade, o que contribui para essa cultura de erotização do corpo infantil.Contudo, alguns meios podem ser tomados para a diminuição desses casos, como o acesso à internet controlado por pais de menores de idades, controle maior de redes sociais para menores, mas acima de tudo uma maior fiscalização e denúncia dessas pessoas que comentam e incentivam crianças e adolescentes a postarem fotos de biquíni, em poses sexualizadas, entre outras.Deste modo, com a conscientização e colaboração de pais e responsáveis e a maior fiscalização e punição de adultos com esse comportamento, é possível criar um ambiente seguro para as crianças e adolescentes na internet, diminuindo assim a cultura da erotização infantil.",160,120,120,160,120,680
6698,152,... ,"O machismo é um impasse social que concerne não só as mulheres em seus cotidianos, em ramos profissionais, religiosos e de entretenimento, mas também abrange os homens no que se refere aos estigmas. Haja vista, a visão opressora que esse empecilho social apresenta em relação às doenças mentais de que esses são distúrbios dispensáveis, sendo assim, banalizados o que provoca , consequentemente, malefícios para mulheres e homens. Nessa perspectiva, é necessário mencionar a ausência de informação e a cultura de banalização de transtornos psicológicos como causadoras dessa problemática.Em primeiro lugar, faz-se fundamental citar a deficiência de conhecimento como impulsionadora do conflito em questão. Destarte, as informações limitadas do corpo social brasileiro associadas aos transtornos mentais acabam por, propulsionar o preconceito que existe atribuído a eles. Diante disso, ao dispor do mínimo conhecimento sobre essas doenças, o sujeito tende a julgar aquele que contém a enfermidade, por justamente essa, não apresentar incapacidade visível e, portanto, alimenta esse estigma. Nesse sentido, essa situação é capaz de prejudicar o doente que passar por julgamentos pois o enfermo sente-se sem apoio emocional, ocorrência favorável a sua doença. Dessa maneira, esse fato diverge do pensamento do filósofo John Locke, que visa a necessidade da reflexão sobre as experiências que o ser humano obtém ao longo da vida para desenvolver o conhecimento. Sendo assim, a sociedade brasileira reproduz a intolerância à doença mental sem ao menos cogitar sobre tais transtornos psicológicos.Além disso, é preciso salientar que as doenças da mente são desconsideradas em analogia àquelas físicas. Sob esse viés, os distúrbios mentais são desprezados e possuem pouca atenção por parte da sociedade. À vista disso, essa banalização é retratada pela escassa investigação profissional e também pelo número crescente de suicídios no Brasil. Dessa forma, a cultura de desdenhar esses problemas de saúde provém de um contexto histórico, pois somente no século XXI que a população iniciou o investimento nesse âmbito psicológico . Isto decorreu por existir esse estigma, o que ocasionou sua conservação por muitas gerações.Tendo isso em vista, é dever do Ministério da Saúde realizar consultas psiquiátricas com a comunidade, por meio do Sistema Único de Saúde e necessita priorizar aqueles que dispõem do diagnóstico da enfermidade. Essa ação tem a finalidade de tornar essa área da saúde menos estigmatizada, ao demonstrar que todos carecem de cuidados com a saúde mental. Logo, a cultura de banalizar e estigmatizar serão apenas lembranças da história brasileira.",160,160,160,200,160,840
6724,152,Escrever sobre o que não tenho ,"Em “Prisão do Rei”, da autora Victoria Aveyard, o Rei Maven Calore se encontra preso em uma das piores prisões: sua própria mente. Acometido por uma doença mental, o jovem rei não se sente confortável em pedir ajuda, pois acredita que não obteria apoio nenhum, tanto da população, quanto de seus próprios aliados. Da mesma forma que o jovem rei, muitas pessoas ainda carregam estigmas quanto às doenças mentais, problema gerado tanto pela idealização do conceito de felicidade, quanto pela disseminação de um padrão pelas redes sociais.Em primeiro lugar, tem o problema da idealização da felicidade. Para muitas pessoas, ser feliz significa não estar triste em momento nenhum, ou obter prazer por meio da compra de bens materiais. Uma conceitualização errônea, visto que, pelas palavras do filósofo Aristóteles, a felicidade não pode ser entendida como a obtenção de bens materiais ou de cargos importantes, mas está entrelaçada com a virtude, que é a capacidade de fazer o bem ao próximo. Dessa forma, muitas pessoas se iludem com esse conceito e criam estigmas quanto as doenças mentais.Em seguida, tem-se o problema da imposição de um padrão de vida, disseminada pelos meios midiáticos. São divulgados pela internet, principalmente pelas redes sociais, um padrão de beleza a ser seguido para se chegar ao bem-estar e à felicidade. Problemas psicológicos são gerados quando esse padrão não é alcançado, como por exemplo, a depressão, que, no Brasil alcança níveis extremos, pois segundo a OMS , o país foi o mais depressivo da América Latina no ano de 2007.Por fim, medidas devem ser tomadas para que a situação seja resolvida. O Ministério da Saúde – principal órgão responsável pela saúde no país – pode , por meio de subsídios cedidos pelo governo federal, promover propagandas nas redes sociais que eduquem sobre saúde mental. Assim como, em conjunto com as escolas promover programas que ajudem os alunos a lidar com problemas envolvendo a saúde da mente e oficinas que promovam o autoconhecimento. Só assim poderemos ter uma realidade diferente daquela apresentada por Aveyard em seus livros.",160,160,120,200,160,800
6789,152,Sem título,"Na Constituição federal brasileira, promulgada em 1988, prevê que todo cidadão tem pleno direito à saúde e bem-estar. Entretanto no Brasil, fica evidente o estigma associado às doenças mentais na sociedade. Nesse sentido, convém analisarmos as principais causas e consequências acerca dessa problemática.Diante de tal cenário, é importante pontuar a falta de informação e atendimento adequado para as pessoas que sofrem de transtornos mentais. De acordo com a Organização Mundial de Saúde, o suicídio - causado pela depressão- fica em 3º lugar em números de mortes no país. É, portanto, inadmissível, que no Brasil ainda não possua clínicas especializadas.Além disso, podemos observar, que a quantidade de indivíduos com problemas mentais aumenta cada vez mais ao longo dos anos. Segundo dados da OMS , as doenças mentais são uma das causas de afastamento do trabalho em todo país. Assim, fica evidente, que medidas precisam ser tomadas de forma urgente, pois as pessoas perdem sua liberdade, como também a sociedade sofre financeiramente.Dessa forma, com intuito de mitigar tal situação, necessita-se, urgentemente, que o Estado, com o apoio do Ministério da Saúde, faça campanhas de conscientização, por meio da mídia, para que tenha maior alcance de indivíduos, a fim de acabar com o preconceito existente acerca dos transtornos mentais e mudar as estatísticas tão alarmantes da OMS.",160,120,120,200,160,760
6794,152,Sem título,"A Constituição federal de 1988, norma de maior hierarquia do sistema jurídico brasileiro, prevê o pleno direito à saúde como inerente a todo cidadão. No entanto, o oposto é o que se observa na contemporaneidade, haja vista que, no Brasil, as doenças mentais podem ser associadas a um estigma, o que desencadeia um alarmante problema Nesse sentido, entende-se que essa configuração se deve, essencialmente, à precariedade de investimentos governamentais no que tange à compreensão e ao tratamento dos transtornos psíquicos e à exposição midiática de pessoas aparentemente desprovidas de problemas.Nesse contexto, é válido ressaltar que as doenças mentais, em muitos casos, passam desapercebidos pelo Poder Estatal. Dentro disso, consoante ao filósofo contratualista de John Locke, o Estado é constituído como responsável pelo domínio político para preservar e consolidar os direitos da população. Contudo, infelizmente, compreende-se que isso não se concretiza no Brasil, uma vez o governo não disponibiliza a todos um sistema de saúde pública qualificado para atender as variadas necessidades psíquicas. Consequentemente, permite que o corpo social permaneça emocionalmente ferido, possibilitando o agravamento da situação. Assim, é substancial a resolução dessa conjuntura.Ademais, outro fator contribuinte para tais transtornos são os cenários fantasiosos de vidas perfeitas mostrados na mídia. Dessa forma, segundo o sociólogo francês Émile Durkheim, a coercitividade é um fato social utilizado pela sociedade para impor padrões sociais aos indivíduos que a integram, obrigando-os a cumpri-los. Nessa linha de raciocínio, na realidade hodierna numerosas pessoas desenvolvem uma alienação acerca de estereótipos padronizados, de modo a se sentirem inferiores, o que acarreta diversos sentimentos negativos, até mesmo enfermidades mentais. Logo, é imprescindível a dissolução dessa problemática.Portanto, são necessárias medidas para a erradicação do estigma. Para isso, é preciso que Ministério da Saúde forneça tratamentos específicos para cada problema mental nos hospitais de cada região, por meio do SUS , com acompanhamento de psicólogo, rodas de apoio e, ainda, introduza na mídia relatos de pessoas que já tiveram depressão ou ansiedade, por exemplo, e se curaram, com a finalidade de promover a melhoria eu bem-estar dos brasileiros. Dessa maneira, a previsão da Carta Magna será efetivada no país.",200,200,160,200,160,920
6806,153,A conscientização do isolamento social devido a crise econômica ,"O distanciamento social está sendo implantado em nossa sociedade desde o começo da pandemia, e suas consequências apenas foram notadas com mais atenção ao decorrer dela. O governo tenta conscientizar a sociedade de permanecer em distanciamento social, no entanto, temos a necessidade de trabalhar e gerar nossa renda para que possamos nos sustentar, e com o fechamento dos comércios, dificuldades surgem, e essa conciliação gera certas controversas. Nesse período, foi destacado a grande desigualdade de classes que já era recorrente muito antes da pandemia.A crise econômica foi abalada pela pandemia, e não as medidas de isolamento implantadas, ou seja, em lugares onde ocorreu o isolamento com maior vigor, os casos foram menores do que cidades que não o implantaram com maior vigência, assim, as cidades se recuperaram mais rapidamente e consequentemente melhorando sua economia. A quarentena no estado de São Paulo continua sendo estendida, voltando fases e não se estabilizando, esse é um efeito da conscientização da população também, que não possui responsabilidade e organizam festas clandestinas ou saem sem a menor proteção, o vírus se propaga com muita facilidade e quanto maior o número de pessoas infectadas, maior o número de leitos em hospitais ocupados, gerando declínio neles também, o que só agrava a situação da saúde pública.Com os dados apresentados anteriormente, pode-se concluir que existe uma instabilidade no distanciamento social junto ao trabalho, mesmo com o auxílio emergencial e suas grandes filas, a não devida importância da população com os mínimos cuidados de proteção e eventos clandestinos, o que só agrava o cenários que estamos vivendo, e só iremos contornar essa realidade quando todos fizerem sua parte, se conscientizando e tendo responsabilidade.",200,160,120,120,120,720
6808,153,A CONTENÇÃO DA PANDEMIA E A RECUPERAÇÃO FINANCEIRA - VI ,"No contexto pandêmico atual, que assolou a população mundial, as medidas sanitárias são as mais eficazes contra sua propagação. A lei 13.979, determina no artigo 3, que podem ser decretadas no combate à epidemia medidas como isolamento e quarentena. Hodiernamente, as medidas de distanciamento têm afetado o setor da economia, gerando graves consequências. Assim mostra-se relevante pensar nesta situação econômica que configura as maiores problemáticas desse pernicioso cenário.De início é notório destacar que as condutas sanitárias têm grande importância no enfrentamento à pandemia, devem ser seguidas e respeitadas, prova disso recai nas reduções de taxas de contaminação e o número de falecimentos entre os contaminados. Ademais cabe ressaltar que as normas acabam afetando vários setores da economia, deixando mais evidentes as desigualdades sociais. No Brasil, o desafio vai além de controlar a pandemia, mas também reduzir a crise econômica. Sendo assim torna-se urgente reconhecer a necessidade de refrear ambas as situações, de modo que garanta a recuperação financeira e conter a epidemia.Com o objetivo de minimizar a crise econômica sem afetar a contenção pandêmica, seria necessária a criação de medidas públicas eficazes. Outrossim cabe aos órgãos governamentais e federais, incentivarem o isolamento evidenciando sua importância, como medida significativa da contenção da transmissão. E como ajuda financeira, a criação de auxílios extras, levando em consideração comerciantes com estabelecimentos fechados, trabalhadores que ficaram sem remuneração, desempregados e a população periférica. Somente assim os cidadãos poderiam respeitar o isolamento, sem passar por dificuldades financeiras, ajudando a economia. Para assim garantir a segurança e a saúde de todos.",160,200,120,160,200,840
6867,153,O isolamento e suas consequências. ,"Atualmente, no Brasil, vivemos um estado de calamidade pública, onde mais e mais pessoas estão perdendo seus empregos e, consequentemente, aglomerando-se em frente das centrais de trabalho. Além disso, muitas subestimam o vírus e não seguem os protocolos emitidos pela Organização Mundial da Saúde, como usar máscara e evitar aglomerações.Muitas pessoas perderam seus empregos desde o começo da pandemia, o que causou muita pobreza assim que a quarentena se iniciou. Famílias de baixa renda, segundo o G1, que mal tinha o que comer antes mesmo do vírus, agora vivem em um estado desumano, onde fazem apenas uma refeição por dia. Além de ser uma situação grave, é preocupante, pois em meio uma crise econômica, uma pessoa que não possuía muito dinheiro para comer mesmo recebendo um salário antes da pandemia, após ela, piorou ainda mais a situação.Ainda que exista desempregados, também existe mais e mais aglomerações nas agências bancárias, por conta dos auxílios concedidos do governo para a população. Porém, essas aglomerações não estão sendo respeitadas e muitos cidadães não seguem os protocolos de segurança, o que leva mais pessoas a contraírem o vírus.Portanto, medidas são necessárias para resolver o impasse. O Ministério do Trabalho, junto ao Ministério da Economia, deve propor a abertura de empregos para as famílias mais carentes, por meio de um projeto de lei entregue à Câmara dos Deputados. Essa abertura iria ajudar a diminuir a crise e ajudar as famílias que precisam achar um emprego. Além disso, o governo deveria conceder multas àquelas pessoas que não seguem os protocolos de segurança em lugares públicos. Espera-se, com essa ação, a diminuição do desemprego e o aumento na economia, assim como o aumento do isolamento social.",160,160,120,160,160,760
6868,153,O uso racional do isolamento social ,"É cientificamente comprovado que o ser humano é socializável. Quando há algo que coloca em risco esse fator é sempre visto como dificuldade para alguns. É o caso do isolamento social imposto pela Covid-19, doença infecciosa cujo o único tratamento é não ter contato com outras pessoas. Esse fato causa grande discordância entre a população, sendo defendida por uns e atacada por outros.O argumento usado e comprovado por aqueles que defendem o isolamento é de que esse é o que possui maior eficácia contra casos e mortes e que se não aplicado em conjunto com outras cidades ou de forma rígida igualmente para todos os cidadãos não possui nenhum efeito, sendo o fechamento de atividades não essenciais necessário. Todavia, deve-se salientar que a quarentena é o método usado muito antes da pandemia que acontece agora, sendo feita desde a peste bubônica que assolou a Europa no século XIV.Entretanto, há aqueles que discordam dessa postura, em sua maioria dizendo que o fechamento de algumas atividades gerará impactos negativos em seus negócios e na economia, de fato que a pandemia obrigou vários empresários fecharem seus negócios e tirou de casa aqueles que não tinham condições financeiras básicas. Em virtude do que foi colocado anteriormente, a crise foi agravada com uma tempestade de notícias falsas e pessimismo em relação aos métodos cientificamente comprovados, comprometendo ainda mais a doença.Nota-se que o Estado deve criar medidas de apoio por meio de auxílios financeiros para aqueles que dependem da rua ou de atividades não essenciais para viver e sustentar seus entes, para que assim diminua os motivos para se sair de casa. Junto com o que foi apresentado anteriormente, o endurecimento de regras é primordial para um isolamento social eficaz, explicando como o método funciona e deve ser exercido. Desse modo, poderemos conscientizar a população e sair dessa crise retornando à normalidade.",160,160,120,160,160,760
6907,153,Sem título,"De acordo o filósofo e pensador chinês, Confúcio, para prever o futuro se deve estudar o passado. A crise econômica e sanitária da Covid-19 que vem sendo um desafio para humanidade nos dias atuais de certa forma assemelha-se ao maior colapso econômico do século XX, a Grande Depressão de 1929. Embora seus motivos tenham sido distintos, a economia foi afetada de forma semelhante, pois em ambos contextos a produção global decaiu radicalmente, assim resultando diversas crises no setor econômico. É um grande absurdo indivíduos que vivem em situação de vulnerabilidade social perderem seus empregos sem previsão de retorno enquanto seus patrões continuam desfrutando de seu capital ilimitadamente.Antes de tudo, é de conhecimento geral que o desemprego é um problema recorrente no Brasil, mas com o estopim da pandemia o número de cidadãos desempregados aumentou de forma drástica. O auxílio emergencial que em tese deveria resgatar a população da crise, infelizmente não cumpriu com seu objetivo. Segundo Aristóteles, o papel da política é manter o bem-estar social, entretanto isso não condiz com nossa realidade mesmo diante de uma pandemia que vem fazendo milhares de vítimas diariamente.Se o Estado fornecesse o devido apoio financeiro e sanitário à população, a dificuldade que está sendo enfrentada poderia ser contida e consequentemente a conjuntura social apresentaria grande melhora e assim a população poderia voltar às suas atividades cotidianas e comerciais com antecedência. Cabe também aos brasileiros exercerem sua cidadania e exigirem suas devidas melhorias e seus direitos como cidadão como consta na Declaração Universal dos Direitos Humanos.Contudo, de acordo com as problemáticas apresentadas, cabe ao Ministério Da Saúde tomar atitudes mais rigorosas em relação às restrições contra o vírus para impedir que o contágio continue se propagando e oferecer também um suporte digno aos brasileiros por meio de verbas governamentais e discursos de conscientização transmitidos pela mídia e outros meios de comunicação. Pois, nas palavras do ex-presidente da República, Michel Temer, “a economia pode ser retomada mas a vida não volta''.",200,160,120,160,160,800
6935,154,A Transfobia no Brasil ,"Hoje em dia uma das questões que ainda é um tabu muito grande na nossa sociedade no geral, tanto no Brasil como no mundo mas principalmente na América Latina é a transfobia, onde pessoas do grupo LGBTQIA+ sofrem preconceito diariamente por causa das suas escolhas. Esses cidadãos pertencentes a tal grupo devem sim ter mais direitos e oportunidades em todas as áreas da sua vida, assim como também devem possuir direitos e tais direitos deverão ser respeitados pela sociedade brasileira.No Brasil a cada dia aumentam os números de pessoas transexuais e travestis e seguindo essa mesma linha aumenta também o número de violência e até mesmo assassinatos contra esses grupos específicos, sendo realizados por pessoas que não sabem respeitar os direitos e as escolhas de outro ser humano como ele. Empresas grandes como multinacionais deveriam começar a dar o exemplo de abrir vagas exclusivamente para pessoas que levam com elas a transexualidade, dando uma oportunidade a uma gama imensa do grupo LGBTQIA+ para ter um trabalho e uma oportunidade de vida melhor além de se sentirem representados nessas áreas. Mas acima de oportunidades deve vir o respeito aos direitos de todos, onde esse ambiente seja propício a uma pessoa trabalhar sem se sentir julgada, criticada ou desrespeitada pelos próprios colegas e seus respectivos superiores. Para que uma pessoa seja respeitada, observando a sociedade que foi, de uma certa forma, acostumada a julgar as escolhas do próximo, infelizmente não temos como desenvolver uma lei para exigir respeito, por dois motivos principais: o respeito deve vir da própria pessoa e o segundo motivo é que, infelizmente, se não houvesse uma punição grave essa lei com certeza não funcionaria.Conclui-se com isso que solução que devemos cogitar por mais que seja difícil conseguirmos, é que todos nós devemos aprender a respeitar as escolhas e principalmente o direito que essa pessoa tem de simplesmente ser quem ela quer ser, sem julgamentos, claro que não temos que obrigar as pessoas a gostar disso, mas a educação e o respeito sempre deve ser o mínimo a ser pedido, todos deveriam saber disso.",160,160,120,120,120,680
7007,154,uma solução para vida em sociedade ,"A diferenciação dos grupos humanos faz parte da construção identitária dos indivíduos. No entanto, uma faceta perversa desse processo inerente da vida humana em sociedade inclui a violência de grupos dominantes contra minorias. A transfobia não é uma exceção a esse padrão histórico. Para lidar com esse problema, muitos defendem a tolerância como solução, porém tolerar não é o suficiente, é preciso entender e respeitar as diferenças.Misoginia, racismo e transfobia são apenas alguns termos que remetem à marginalização e à violência contra grupos minoritários com base em suas diferenças. Um exemplo disso é percebido quando a transfobia é cometida por integrantes de outros grupos LGBT+ , que mesmo sofrendo com a homofobia praticam os mesmo padrões de intolerância ao diferenciarem pessoas transgênero.A simples tolerância aos grupos minoritários não é suficiente para lidar com esse problema. Tolerar significa ignorar ou apenas permitir a existência do outro, enquanto o que as minorias precisam é de respeito e aceitação como parte integrante da sociedade. E para que isso possa ser possível, a solução mais adequada é pelo contato saudável entre os grupos. Entender a diferença é uma etapa para respeitá-la, mas só haverá compreensão de fato se houver espaço para o diálogo entre os grupos.Sendo assim, o Ministério da Educação é responsável por iniciar um padrão de maior respeito às diferenças a partir das escolas. Deve haver na educação dos jovens espaço para o diálogo sobre as diferenças. Pessoas transgênero, por exemplo, precisam de espaço de fala para desfazer falsas concepções e estereótipos a fim de melhorar a interação entre os diversos grupos da sociedade.",200,160,120,160,120,760
7038,155,A CIÊNCIA É FUNDAMENTAL ,"A globalização- processo de expansão política e cultural- intensificou as relações de comunicação, bem como auxiliou no desenvolvimento tecnológico tornando a informação instantânea e próxima. No entanto, tal conjuntura encontra-se fragilizada, haja vista que o negacionismo científico se amplia na sociedade e os seus efeitos são alarmantes. Isso ocorre não só em razão da desinformação social, mas também de falhas no sistema educacional. Assim, é imprescindível a mudança dessa situação, o que pressupõe uma discussão.Diante desse cenário, apesar do avanço da tecnologia nem todos os indivíduos têm acesso à informação científica. Esse fenômeno é retratado pelo escritor Gilberto Dimenstein, em sua obra “Cidadãos de Papel”, no que tange a inefetividade dos direitos constitucionais, sobretudo, na desigualdade de oferta dos benefícios normativos. Nesse contexto, a ausência de notícias legítimas do campo científico que tenham fácil acesso para a população, principalmente, periférica contribui para o negacionismo. Consequentemente, a volta de enfermidades antes erradicadas e o uso de produtos sem nenhuma base científica, por exemplo, se tornam constantes. Dessa forma, é indispensável reverter esse panorama para que a informação verdade chegue aos lares brasileiros e a ciência seja exaltada.Outrossim, vale ressaltar que o modo como a educação é lecionada amplia pouco a área científica nas escolas. Sob esse viés, os colégios prezam mais por conteúdos técnicos em detrimento de um pensamento crítico proporcionada pela ciência, ou seja, debates sobre a profissão do cientista e os processos aplicados nesse ramo são fundamentais para evitar o negacionismo . Nesse sentido, o educador Paulo Freire defende que a educação é a porta para a mudança social e, sem ela, estaremos desamparados, o que revela a importância da escola como meio difusor de conhecimentos.Portanto, são necessárias medidas para mitigar e superar o impasse. Urge que Ministério da Ciência e Tecnologia, por meio de verbas governamentais, crie um site na internet e divulgue mensalmente projetos e estudos científicos em uma linguagem acessível para o corpo social, com o fito de democratizar a informação. Ademais, o Ministério da Educação deve realizar palestras no âmbito escolar, por intermédio de atividades pedagógicas com a participação de cientistas e professores de Biologia e Química, os quais dissertem acerca da relevância da ciência e sua utilidade, a fim de romper a barreira de negação dessa disciplina. Espera-se, com isso, a efetivação da globalização como propulsora de progresso junto à prosperidade de um legado social.",160,160,160,200,200,880
7040,155,A descrença da sociedade ,"É fato que segundo a Constituição de 1998, cada cidadão brasileiro tem o direito de ter sua própria opinião sobre qualquer assunto, independente de censura ou licença; porém, o negacionismo científico, a ação de não acreditar em conceitos básicos da ciência, está ultrapassando a liberdade de expressão e causando danos severos a população. Diante deste quadro, é necessário analisar os fatores que o agravam.Primeiramente, é válido destacar que o principal efeito de uma população que não crê na ciência é o retorno de doenças já antes erradicadas no país, como é o caso da poliomielite, hepatite A, meningocócica C e outras enfermidades que não atingiram a meta de vacinação nos últimos anos e há muito tempo não tiravam a vida de tantos indivíduos como agora. É inadmissível que no Brasil, um lugar que já possui as vacinas, medicamentos e tratamentos dessas doenças, pessoas tenham que morrer por não acreditarem na ciência.Outro efeito que pode ser observado é que as verbas para universidades e centros de pesquisa são cortadas, já que para a população não é importante, também não será relevante para os governadores que escolherem. Lamentavelmente, com a falta de dinheiro para a educação, as informações falsas e o negacionismo científico só crescerão na sociedade brasileira.Desse modo, pode-se concluir que essa descrença irá apenas impedir o crescimento e desenvolvimento de milhares de vidas e da educação brasileira. Assim, o Ministério de Educação deve disponibilizar mais dinheiro para as universidades, centro de pesquisas e escolas com a finalidade de aumentar o espaço da ciência dentro do país, diminuindo então o negacionismo científico. Só assim, o Brasil poderá superar esse problema.",160,160,120,200,160,800
7058,155,"Brasil contra o retrocesso, o sofrimento e o risco. ","Na ciência, o negacionismo é definido como a rejeição de conceitos básicos e incontestáveis, apoiados por consenso científico, em detrimento de ideias radicais e controversas. O maior exemplo disso na atualidade brasileira é o próprio presidente da nação negar a importância da vacinação frente a pandemia do covid-19, custando milhares de vidas. Diante desse contexto, é notório que o negacionismo científico causa prejuízos tanto a saúde quanto, ainda, a educação dos brasileiros.Quanto ao primeiro ponto, é importante perceber que o negacionismo científico está intimamente relacionado as fake news, ou seja, o compartilhamento de desinformação ou boatos através, principalmente, das redes sociais. Um reflexo disso está no fato de que, segundo o jornal Uol, no Brasil, o sarampo retornou em 2019 e a vacinação contra a poliomielite, que desde 1990 estava controlada, em 2016 não atingiu sua meta. Pois o movimento antivacina, que não possui nenhum embasamento, tem feito o índice de vacinação cair e doenças contagiosas erradicadas ou perto disso voltaram a aparecer. Observar um cenário como esse é avistar um quadro de retrocesso sofrimento e riscos.Ademais, é correto afirmar que a educação está sendo negligenciada pela ação do negacionismo científico. Uma vez que o Brasil tomou a decisão de fazer cortes inimagináveis em universidades federais responsáveis por pesquisas capazes de melhorar consideravelmente as condições de vida da população. A exemplo disso está a pele de tilápia usada no tratamento de queimaduras, desenvolvida na universidade federal do Ceará, mas que já é utilizada em outras partes do mundo. Logo, negar conhecimento é reconhecer a ignorância, a educação deve ser vista como um valor e a ciência como um recurso a ser explorado.A par das considerações feitas, cabe refletir sobre iniciativas capazes de combater o negacionismo científico no Brasil. Diante disso, o MEC - Ministério da Educação, órgão responsável pela legislação e regulamentação da educação no Brasil - deve adotar uma democracia direta, isto significada, uma organização na qual todos os cidadãos podem participar diretamente do processo de tomada de decisões. Isso dentro da sua capacidade de compreensão, desmistificando jargões científicos. Afinal, é natural que o desconhecido assuste, e uma decisão como essa significa estar ao lado do progresso e da educação, dito que o conhecimento não deve ser de propriedade apenas dos cientistas. Com essa finalidade, todos os brasileiros sentir-se-ão representados.",160,200,160,200,160,880
7094,155,Negacionismo científico: efeitos. ,"O negacionismo, isto é, o não reconhecimento de um fato, pode ocorrer principalmente de duas maneiras: ao negar a seriedade de uma situação crítica e ao contestar a credibilidade das fontes tradicionais de conhecimento. Essas duas formas de negacionismo estão presentes na sociedade brasileira atual e geram consequências tanto para a gestão política e para a saúde pública quanto para a disseminação do conhecimento. Assim, importa analisar as causas e efeitos desse fenômeno que, em um contexto de pandemia, é fortemente alimentado ao mesmo tempo que torna-se um dos grandes obstáculos para a gestão pública.Primeiramente, é relevante perceber que o negacionismo costuma ascender na sociedade em momentos de crise, já que instituições tradicionais mostram-se insuficientes para solucionar os problemas mais urgentes. No entanto, hoje o negacionismo ganhou ainda mais força por causa das redes sociais. Os novos meios de comunicação da atualidade contribuíram para pôr os negacionistas em evidência e disseminar suas ideias. Consequentemente, “fake news”, que em outros contextos seriam ignoradas, são utilizadas para descredibilizar fundações científicas e governamentais usualmente consideradas fontes confiáveis de dados e conhecimentos. Além disso, a desinformação produzida pelas “fake news” coloca a saúde da população em risco ao divulgar tratamentos para doenças sem fundamentação científica e descredibilizar tratamentos factíveis e medidas de combate à disseminação de doenças, principalmente a covid-19.Da mesma forma, a vacina, principal estratégia de combate à pandemia, está sendo contestada pelos negacionistas. Mesmo antes da atual crise sanitária e independentemente do Brasil ser um dos poucos países com um sistema de saúde pública com calendário integrado de vacinação, casos de doenças, como o sarampo e a BCG, voltaram a crescer devido à diminuição na taxa de imunização. Esse fato é alavancado, principalmente, por pais que acreditam, sem fundamentação científica, que as vacinas possam ser prejudiciais para seus filhos.Paralelamente, no âmbito político, o negacionismo pode gerar uma formulação inadequada da gestão pública. Isso pode ser observado no governo negacionista do presidente mexicano López Obrador. Ao negar a gravidade da pandemia, esse governo não formulou uma política de combate à disseminação da covid de forma eficiente e em tempo ágil, como é necessário, nem tentou garantir um rápido fornecimento de vacinas para seus cidadãos. Assim, a morosidade no planejamento público gerou para o México o título de terceira nação com o maior número de mortes por covid-19.Posto isso, é de simples compreensão os efeitos que o negacionismo, tanto na esfera política quanto em relação à ciência, provoca para a sociedade. Assim, é de inegável relevância uma atuação conjunta do Ministério da Educação, pais e sociedade em geral para a promoção da educação, do combate à disseminação de “fake news”, além da promoção de políticas de transparência das instituições tradicionais de conhecimento para fortalecer a confiança depositada nelas e aproximá-las da sociedade.",160,160,160,200,160,840
7112,155,Os efeitos do ceticismo na sociedade brasileira ,"O movimento antivacina surgido na segunda metade do ano de 2020 – época do desenvolvimento de várias vacinas contra o coronavírus- evidenciou o negacionismo científico enraizado na sociedade brasileira. Nesse contexto, pode-se destacar a valorização do senso comum como uma das principais causas para os efeitos irreparáveis que esse ceticismo pode ter na sociedade brasileira.Em primeira instância, é essencial destacar o culto ao senso comum – algo presente no pensamento coletivo, mas sem valor científico- como uma das principais causas para a desvalorização dos métodos científicos no Brasil. Sobre isso, pode-se mencionar uma notícia falsa que foi propagada em 1998, a qual consistia na ideia de que a vacina Tríplice viral – vacina contra o sarampo, a caxumba e a rubéola – provocava o autismo. Essa ideia, apesar de ter sido negada e comprovada cientificamente, ainda é tida como uma verdade irrefutável para parcela da população brasileira, o que demonstra a ignorância, a desinformação dos brasileiros acerca dos métodos baseados na ciência e prejudica o desenvolvimento da nação.Além disso, esse ceticismo exacerbado pode ter desdobramentos irreversíveis com o reaparecimento de doenças emergentes. A esse respeito, é imprescindível mencionar o reaparecimento do sarampo, em 2019, no Brasil devido, provavelmente, às notícias falsas que fizeram a população acreditar que a vacina Tríplice viral tinha como um dos efeitos colaterais o autismo. Esse fato demonstra as consequências negativas que o negacionismo científico pode ter na comunidade brasileira, já que o reaparecimento de doenças emergentes pode provocar uma crise no sistema de saúde.É necessário, portanto, que o Ministério da saúde, com o objetivo de esclarecer a importância da ciência, elabore campanhas – que terão a participação de cientistas e pesquisadores, os quais tentarão esclarecer o quão essencial são as práticas científicas para o desenvolvimento da nação brasileira – informativas . Essa proposta poderá ser divulgada por meio da mídia, especificamente, nas redes sociais, a exemplo de Facebook e Instagram, haja vista que têm um público mais amplo.",200,160,160,200,160,880
7149,156,*** Como combater o preconceito amarelo ,"De acordo com a Constituição Cidadã, promulgada em 1988, todos são livres e iguais em dignidade e em direitos. Hoje, apesar de o respeito étnico fazer parte dos direitos sociais, a persistência do preconceito amarelo fere diretamente a Carta Magna, já que é evidente uma relação desigual entre a população asiática e as demais. Mediante a isso, cabe debater sobre formas de combatê-lo, além de suas causas, como a falta de denúncias e a má influência da mídia, a fim de cessar a realidade vigente.A priori, pode-se afirmar que a ausência de denúncias é um fator determinante à continuação do racismo em pauta. Para o filósofo Immanuel Kant, entretanto, o indivíduo deve agir conforme a máxima que deseja ser transformada em lei universal. Nesse sentido, tendo o Estado como único autor do processo judicial, as pessoas não deveriam ter receios em denunciar atos preconceituosos contra os asiáticos, a exemplo do que acontece ao sofrerem injúrias acerca do formato de seus olhos. Caso contrário, pois, o atual panorama que os sujeitos desejam alterar, dificilmente terá como combater. Assim, uma manutenção dos valores comportamentais da sociedade é um caminho redesenhador do tema em questão.Outrossim, o preconceito amarelo encontra terra fértil na negativa influência midiática ao silenciá-lo. Segundo o postulado bourdieusiano o que foi criado para ser instrumento da democracia não deve ser convertido em mecanismo de opressão. Nesse contexto, quando se invisibiliza a pré-existência do assunto, a mídia acaba naturalizando a sua prática cada vez mais. Pela falta de seu entendimento como sério comprometedor da democracia cívica, portanto, o racismo permanece sendo exercido sobre o povo asiático. Logo, esse mecanismo de opressão funciona como forte empecilho para resolução da problemática.Em suma, o preconceito amarelo está presente na contemporaneidade e necessita ser combatido. Para mudar esse quadro, o governo federal, juntamente com o Ministério das Comunicações, deve criar o projeto ''Não há cor para o preconceito'', destinado à sua população. Esse programa televisionário estará atrelado nas emissoras de televisão. Com o intuito de tornar o preconceito amarelho de conhecimento público, haverá apresentação de depoimentos próprios das vítimas sensibilizando o resto da nação a assumir uma postura de respeito à etnia. Feito isso, o preconceito contra os ascendentes da Ásia será derrotado, e o previsto da Constiuição de 1988 garantido.",160,200,160,200,160,880
7150,156,**Como combater o preconceito amarelo* ,"Na Era Vargas, os japoneses e chineses eram representados de maneira estereotipada pelas revistas e charges da época, pois tais indivíduos eram considerados imigrantes indesejáveis. No Brasil atual isso não ocorre mais, porém, ainda é possível observar que o preconceito contra os amarelos continua presente na sociedade . Nesse contexto, percebe-se a configuração de um grave problema em virtude da lenta mudança de mentalidade e do silenciamento.Convém ressaltar, a princípio, que a lenta mudança de mentalidade é um fator determinante para a persistência do impasse. De acordo com Durkheim, o fato social é a maneira coletiva de agir e de pensar. Seguindo essa linha de raciocínio, nota-se que o racismo contra pessoas de origem ou ascendência asiática pode ser encaixado na teoria do sociólogo, uma vez que, se as pessoas crescem inseridas em um contexto social discriminatório, a tendência é adotar esse comportamento também. Assim, o fortalecimento do pensamento preconceituoso, transmitido de geração em geração, resulta numa sociedade cada vez mais xenofóbica em relação aos indivíduos que são amarelos.Além disso, outra dificuldade enfrentada é o silenciamento. Segundo o filósofo Habermas, a linguagem é uma verdadeira forma de ação. Dessa forma, para que um problema como o preconceito contra os amarelos seja resolvido, faz-se necessário debater sobre. Entretanto, percebe-se uma lacuna no que se refere a essa questão, que ainda é muito silenciada. Portanto, trazer à pauta esse tema e debatê-lo amplamente aumentaria a chance de atuação nele.Logo, medidas estratégicas são necessárias para alterar esse cenário. Para que isso ocorra o Ministério da Educação, juntamente com o Ministério da Mulher, da Família e dos Direitos Humanos, devem desenvolver palestras em escolas por meio de entrevistas com as vítimas do problema, bem como especialistas no assunto. Tais palestras devem ser webconferenciadas e divulgadas nas redes sociais dos ministérios, com o objetivo de alcançar um público maior e trazer mais lucidez sobre o preconceito amarelo. Assim, como propõe Habermas, encontraria-se um meio de solucionar a questão por meio do uso da linguagem.",160,200,160,200,200,920
7203,156,O preconceito como fruto da ignorância ,"O preconceito contra asiáticos e seus descendentes sempre esteve presente em nossa sociedade. Porém com o advento da pandemia de Covid-19, esse preconceito tornou-se evidente e foi ampliado. Desta maneira, faz-se necessário que a sociedade como um todo tome medidas contra esse preconceito, que é apenas mais um, dentre as mazelas que afligem o povo brasileiro.A cultura de massa, teorizada pelos filósofos da escola de Frankfurt, é uma das fontes desse preconceito contra o diferente. Ela está sendo reproduzida de maneira exponencial, tornando tudo aquilo que é fora do padrão estabelecido, alvo de crimes de ódio. É através dessa padronização cultural, que surge o preconceito racial contra asiáticos, por eles não fazerem parte do padrão tido como ideal.Portanto, faz-se necessário, em primeiro lugar, que a família como um dos mais importantes pilares da nossa sociedade, atue no combate a essa intolerância, criando as suas crianças, futuros adultos, de maneira a não perpetuar esse preconceito, um dos piores males da nossa sociedade. Da mesma maneira, é de extrema importância, a escola ampliar a difusão dos ideiais de equidade e aceitação do diferente, através de palestras que visem acabar com a ignorância, que como William Hazllitt dizia, é a mãe do preconceito. Em última análise, a atuação do legislativo faz-se necessária, de maneira a tornar as leis mais severas, visando inibir de certa maneira, à prática do preconceito.",160,120,80,120,160,640
7226,156,Preconceito Amarelo : Um Problema a ser Combatido ,"O filósofo Sócrates afirmou que não era ateniense nem grego, mas sim um cidadão do mundo, demonstrando não discriminar indivíduos de diferentes origens. Contudo, ao se analisar as atitudes da maioria dos ocidentais frente as pessoas asiáticas, percebe-se uma aversão, distante do pensamento de Sócrates, a qual foi impulsionada pelo fato do Covid-19 - vírus que gerou uma crise na saúde global - ter surgido na China. Porém, cabe destacar que o preconceito amarelo não é algo recente, como a pandemia do novo coronavírus, já que ele já está consolidado nas nações ocidentais, sendo gerado pela desinformação a respeito dos povos asiáticos e intolerância instantânea a tudo que é considerado diferente.Primeiramente, é notório a existência de uma desinformação em massa sobre as culturas de procedência asiática, sendo esse aspecto nítido nas redes sociais. Segundo o filósofo Parmênides, o caminho do engano é aquele apoiado nas opiniões aceitas sem reflexão. Sob mesmo ângulo, a aceitação, sem questionamentos, de todas as informações, principalmente relacionadas aos hábitos alimentares asiáticos, disponibilizadas na internet gera uma aversão desfundamentada aos povos orientais. Logo, para se combater o preconceito amarelo, deve-se sanar a desinformação.Por outro lado, a intolerância a tudo que é considerado diferente também é responsável pelo preconceito amarelo. De acordo Arthur Schopenhauer, filósofo alemão, todo homem torna os limites do seu próprio campo de visão como os limites do mundo. Em consonância a essa ideia, a determinação de hábitos individuais como sendo corretos pode ser considerada responsável pela repulsão a tudo que se distingue desse padrão. Dessa maneira, a cultura oriental é tida, pelos ocidentais, como sendo estranha e errada, já que não abrange elementos considerados normais àqueles que não compartilham dos mesmos hábitos.Portanto, urge a necessidade de se combater o preconceito amarelo. Assim, o Ministério da Educação, cuja função é garantir um ensino de qualidade no Brasil, deve criar uma cartilha que desmistifique os preconceitos relacionados ao povo oriental, por meio do fornecimento de informações verídicas sobre a diversificada cultura existente no continente asiático, a fim de que ideias de cunho xenófobo deixem de fazer parte da sociedade brasileira. Além disso, tais cartilhas deverão atender não somente aos estudantes, mas também a toda população, que poderá acessá-las pelas redes sociais do Ministério da Educação. Destarte, todos passarão a defender que não são ocidentais nem orientais, mas sim cidadãos do mundo, em consonância ao que foi postulado por Sócrates.",200,200,160,200,200,960
7228,156,Preconceito Amarelo na Sociedade Brasileira: {( asiáticos)} ,"O preconceito amarelo é uma discriminação, rejeição contra pessoas ascendentes de países asiáticos, que podem envolver tanto atos de agressões físicas, morais quanto psicológicas contra estes indivíduos. Diante disso, na realidade brasileira, esse comportamento é um sério problema para o país. Dentre tantos fatores relevantes temos: o alto índice de fake news no Brasil e o aumento da violência no país.Em primeiro plano, sabe-se que o crescimento de informações falsas é uma das causas da disseminação desse comportamento. Segundo o Presidente da República Jair Bolsonaro, a Covid-19 pode ter sido criada em um laboratório pelo país asiático como parte de uma bacteriológica. Na revista Nature Medicine, um estudo realizado por pesquisadores dos Estados Unidos, Austrália e Reino Unido comprovou que o novo coronavírus não foi criado em laboratório. A partir de uma análise, os cientistas encontraram evidências de que provavelmente o vírus seja resultado de seleção natural. “Nossas análises mostram claramente que não é uma construção de laboratório ou um vírus propositalmente manipulado”, afirmam os pesquisadores. Sendo assim, é preciso desacelerar o ritmo de fake news para que menos pessoas apoiem ou acreditem em notícias inverídicas.Ademais, o preconceito contra asiáticos é um problema que não para de crescer no país. Segundo dados do Centro de Estudos do Extremismo da Universidade Estadual da Califórnia, foram registradas quase 4.000 denúncias de violência e 8 casos de óbito nos Estados Unidos contra esses grupos. Nesse sentido, pelo artigo da Constituição federal de Lei n.º 7.716, é crime o ato de praticar, induzir e incitar a discriminação de raça, cor, etnia, religião e procedência nacional, que pode levar de um a três anos de reclusão e multa. Sendo assim, é crucial que maiores investimentos sejam feitos para que desacelere o nível de disseminação de ódio.Portanto, para efetivar a queda do preconceito amarelo no Brasil é necessário que o governo- órgão responsável pelos Três Poderes- promova Campanhas de Combate ao Preconceito em parceria com a mídia por meio de verbas governamentais, a fim de desacelerar o nível de vítimas de atos preconceituosos na sociedade. Só assim a intolerância que assola a realidade brasileira se extinguirá.",160,160,160,200,160,840
7238,156,"Preconceito, um mau oculto ","No século passado, o mundo passava por diversas guerras e perseguições, uma delas foi o nazismo, movimento que perseguiu e matou cerca de 8 milhões de pessoas de origem judaica. Isso mostra que o preconceito contra pessoas de diferentes etnias é um problema recorrente na história da humanidade. Apesar de o Brasil ser um país bem mistificado, é comum relatos de vítimas que sofreram discriminações por conta de suas origens étnicas. Dessa forma, o combate ao preconceito amarelo é um desafio que precisa ser combatido com uma desculturação de pejorativos aos asiáticos, como também uma fiscalização dos meios virtuais.Convém ressaltar, a princípio, que a cultura de se criar apelidos aos povos de origens asiáticas é um fator determinante para permanência do preconceito, caracterizando-se como violência verbal. De acordo com as ideias do filósofo Jean-Paul Sartre, a violência seja ela física ou verbal, quando manifestada é uma derrota quando se há um mau a ser combatido. Nesse sentido, esses costumes de maus hábitos têm se tornado um empecilho para se combater o preconceito, visto que ele é um dos responsáveis pela disseminação de estigmas dos povos asiáticos.De mesmo modo, destaca-se o aparecimento de notícias falsas como uma das ferramentas usadas para caluniar certos países com divulgação de conteúdos falsos e até mesmo de ódio contra essas nações. Isto é, recentemente a China foi vítima de uma cancelamento virtual, na qual muitas pessoas publicaram inúmeras notícias inverídicas na internet que diziam que ela foi a responsável pelo aparecimento da covid-19, fato esse que provocou um aumento no número de crimes contra os chineses espalhados pelo mundo. Assim como a internet se tornou um ambiente para divulgação e debate sobre diversos assuntos, infelizmente tem sido usada também para propagação de “fake news” com o objetivo de cancelamento virtual de uma pessoa ou nação.Portanto, diante dos fatos supracitados, faz-se necessário que sejam tomadas ações para amenizar a questão. Logo, o Estado junto com os poderes legislativos e judiciais, por meio de criações de leis, ademais dos cumprimentos das que já estão em vigor, devem aumentar a fiscalização e fazer a justiça de forma mais ágil, para que assim diminua o compartilhamento de discursos de ódios, como também para as pessoa que infringem as leis respondam processos criminais. Além disso, as escolas devem formar cidadãos que respeitem as diferentes etnias. Em suma, é importante que sejam discutidos na aulas assuntos sobre as culturas de cada país, bem como o respeito a todos. Somente assim, esse preconceito será gradativamente erradicado, pois, conforme Gabriel O Pensador, “Na mudança do presente a gente molda o futuro”.",160,160,120,200,160,800
7240,156,Redação 2 - Preconceito Amarelo ,"Durante o final do século XIX, foi impulsionado o movimento migratório de povos orientais para o Brasil. Nesse período, intelectuais brasileiros debatiam a suposta degradação racial que a relação entre nativos e asiáticos causaria, o que reflete discriminação racial. Este tipo de preconceito foi naturalizado no Brasil e, a partir disso, observa-se a necessidade de respeito a essa etnia que ainda sofre com estereotipagem e foi acusada de ser responsável pela atual pandemia de covid-19.Em primeiro lugar, ainda existem muitas demonstrações xenofóbicas enraizadas na sociedade brasileira. Comentários como “asiáticos são todos iguais” são frequentes, além dos padrões criados, e quando descendentes não atendem a esses estereótipos são menosprezados e inferiorizados. De acordo com o filósofo René Descartes, toda forma de preconceito e precipitação deve ser evitada em quaisquer análises e apenas deve ser considerado o que for indubitável e distinto, percebe-se então que tipificar asiáticos e seus descendentes os impede de demonstrar suas essências verdadeiras e individuais. Portanto, é necessário remover essas categorizações que inibem este grupo social e suas possibilidades de mostrarem-se únicos.Ainda convém lembrar que, a pandemia de covid-19 foi utilizada como pretexto para atitudes e discursos preconceituosos contra asiáticos. Segundo o site de notícias G1, em 2020 administradores tentaram segregar o acesso de trabalhadores de um escritório de uma empresa chinesa. Tal fato demonstra uma suposta acusação de que chineses estivessem espalhando o vírus propositalmente e que são os culpados por esta pandemia. Assim, a lei 7.716 que estabelece que praticar discriminação de raça ou etnia é passível de punição deveria ser cumprida mais assiduamente.Em suma, o preconceito amarelo deve ser combatido. Cabe ao governo federal cumprir a lei supracitada, monitorando perfis e acolhendo ocorrências de insultos xenofóbicos e punindo os autores conforme o Código Penal. Além de caber às escolas estimular a criação de eventos e atividades que exaltem a diversidade étnica, com a a finalidade de, através da educação, romper estereótipos em relação aos asiáticos, enraizados na sociedade brasileira. Para que, dessa maneira, equívocos disseminados há muitos anos a respeito do povo amarelo sejam, gradativamente, extintos.",160,160,160,200,160,840
7279,157,As responsabilidades na concepção de um indivíduo. ,"O Código de Ética Médica, em seu capítulo V, expõe ser vedado ao médico desrespeitar o direito do paciente ou representante legal na escolha de práticas diagnósticas, ou terapêuticas, a não ser em casos de risco de morte eminente. Acerca do nascimento de um novo indivíduo, é indispensável que seja de maneira afável e humanizada, visando respeitar e cumprir com esse direito ao longo de todo o processo, mas principalmente no trabalho de parto.Quando se trata de saúde, é natural que haja a confiança nos profissionais, para que os mesmos ofereçam a melhor solução. Porém, cada indivíduo possui suas particularidades, e se tratando do ato de conceber um filho, é compreensível que existam medos, dúvidas e ignorâncias . Sendo assim, é responsabilidade do médico expor as possibilidades de tratamentos disponíveis, assim como esclarecê-los, proporcionando uma escolha mais consciente.Ainda convém lembrar que, não se trata apenas de ética, e sim de uma relação profissional primeiramente entre o Ministério da Saúde e seus funcionários, e em seguida, entre paciente e equipe hospitalar, sendo necessária a empatia, a confiança e o respeito. Dessa forma, o ambiente adequado, com equipamentos de qualidade e recursos básicos que supram o essencial, influencia diretamente no cumprimento de um bom trabalho.Portanto, para ser ofertado um acompanhamento, e principalmente um parto, mais humano, o qual respeite além do corpo, as preferências de cada mulher, deve haver um constante monitoramento, por parte das pacientes e/ou seus acompanhantes ao longo do tratamento, do cumprimento do direito de autonomia de escolha, garantido no Código de Ética Médica. Assim como, é de responsabilidade do Ministério da Saúde garantir aos seus funcionários os meios, como: equipamentos de qualidade, remuneração apropriada, e infraestrutura que possibilitem a execução de um trabalho adequado.",160,120,120,160,80,640
7367,157,Sem título,"O momento tão esperado para a mulher que está na espera de ver seu filho pela primeira vez, pode se tornar traumático. Tendo em vista sua condição, a mulher grávida espera o melhor atendimento, mas se frustra ao não ter seu corpo respeitado no momento do parto pelos profissionais que usam do tormento psicológico ao realizar o procedimento, tornando o parto estressante e podendo causar complicações. Há casos que vítimas desse abuso escolhem não ter o acompanhamento médico, movidas a insegurança e medo, se colocando em risco de vida.Primeiramente, o corpo do sexo feminino é historicamente vítima de invasões e a vontade da mulher é invalidada, deixando passagem livre para que os abusos no parto sejam banalizados e não enxergados como violação. Apesar de pouco falado do que deveria, no Brasil, a desumanização do parto se expressa nos dados, com partos cesáreas que exorbitam os 15% admitidos pela OMS , evidenciando que se trata de uma questão de saúde pública.Além disso, a presença da apelação de pressão psicológica por parte de médicos e enfermeiros suscitam traumas irreversíveis na autoestima dessa mulher, a levando optar por não querer o auxílio médico, podendo acarretar consequências fatais, antes mesmo do parto, para mãe e feto.Com o objetivo de mudar esse cenário, é imprescindível que se discuta a violência e a humanização do parto com os profissionais de saúde responsáveis pelo atendimento e haja a iniciativa do governo, em conjunto com as mídias sociais, agir através de campanhas informativas de conscientização dando voz às vítimas . Somente assim, garantindo sua integridade física e moral, que as mulheres se sentirão seguras e respeitadas.",160,120,120,120,80,600
7393,158,A inclusão na contemporaneidade ,"Na Antiguidade Clássica, rejeitar e abandonar crianças portadoras de deficiências físicas ou transtornos mentais era uma prática comum entre os povos gregos e romanos. Atualmente, por mais que esse hábito hediondo tenha desaparecido e a vida dos indivíduos com condições especiais esteja sendo mais valorizada, milhares de autistas ainda enfrentam sérias dificuldades de inclusão social no Brasil. Nesse contexto, é importante analisar a desqualificação dos profissionais e o preconceito como principais aspectos motivadores dessa problemática.Convém ressaltar, a princípio, que a inexperiência, somada à falta de treinamento de muitos professores de Educação Especial, resultam na estagnação social e intelectual dos alunos. Segundo o filósofo Sêneca: “A educação exige os maiores cuidados, pois influi sobre toda a vida”. Nesse sentido, a capacitação de um corpo docente instruído e versado, capaz de assimilar as particularidades de cada sujeito, é indispensável ao desenvolvimento das capacidades cognitivas dos autistas. Tendo em vista os obstáculos na comunicação e interação social dessa parcela da sociedade, cabe aos orientadores auxiliarem e estimularem a socialização para com os colegas de classe, professores e funcionários.Além disso, a utilização do autismo como um adjetivo pejorativo cria concepções discriminatórias que comparam o transtorno a doenças mentais mais graves, como a demência. De acordo com o filósofo Diderot: “A ignorância não fica tão distante da verdade quanto o preconceito”. De maneira análoga, depreende-se que um dos problemas da inclusão não está pautado no desconhecimento dos brasileiros acerca do distúrbio, mas sim em noções equivocadas que, além de denegrirem a imagem dos autistas e levarem muitos deles ao isolamento social, suscitam a difusão de informações falsas sobre o transtorno.Portanto, diante o problema apresentado, faz-se inadiável a execução de medidas estratégicas capazes de promover a integração desses indivíduos na sociedade. Para tal, é papel do Ministério da Educação – órgão responsável pelas políticas educacionais – providenciar a qualificação dos profissionais da Educação Especial e elucidar o conceito de autismo, por meio de palestras e seminários webconferenciados para alunos e professores, a fim de que haja pleno desenvolvimento individual dos autistas e maior compreensão a respeito de todos os fatores que envolvem o distúrbio. Somente assim, ampliando a educação, será possível contrariar a moral greco-romana e valorizar toda e qualquer vida.",160,200,160,200,200,920
7417,158,Autismo: desafios para a inclusão ,"Inclusão social vai muito além de colocar pessoas com diferentes necessidades para participar de atividades conjuntamente. É também necessário que o meio onde indivíduos especiais serão inseridos esteja preparado para recebê-los. Nesse sentido, no que concerne ao autismo, poucas escolas possuem a devida estrutura. Além disso, a sociedade brasileira ainda carece de informações e entendimento acerca do tema.Primeiramente, boa parte das escolas ainda é um ambiente hostil não só para crianças com autismo, mas para qualquer uma que fuja aos padrões da maioria. No caso do autismo, a situação fica ainda mais delicada pois faltam profissionais e educadores capacitados para lidar com esses indivíduos. Assim, faz-se necessário que as instituições educacionais forneçam programas de capacitação aos seus professores acerca do tema, ou que contratem um número mínimo de profissionais especializados para atuar em conjunto com os educadores.Ademais, a falta de conhecimento e familiaridade por parte da população também se reflete nas dificuldades para a inclusão. Muitas vezes as peculiaridades de um autista são vistas, pejorativamente, como meras frescuras . É preciso que a população entenda que esses problemas, independentemente da intensidade, decorrem de um quadro patológico, que precisa ser analisado sob uma ótica mais sensível e empática. Além disso, é imprescindível que os pais estejam envolvidos com o cotidiano escolar dos filhos, e os conscientizem sobre as necessidades especiais de cada um, de modo a evitar casos de bullying e discriminação.Portanto, cabe a órgãos como o Ministério da Educação, responsável pelo sistema educacional nacional, instituir programas que visem aperfeiçoar a estrutura das instituições públicas e privadas para lidar com tais questões. Somado a isso, é importante que agentes midiáticos como emissoras de TV aberta e sites de notícias continuem ampliando o debate acerca do autismo, para que a população entenda a importância dessa questão na busca por uma sociedade mais humanitária e equânime.",160,160,120,200,120,760
7476,158,Sem título,"Segundo o filósofo George Santayana, aqueles que não conseguem lembrar o passado estão condenados a repeti-lo. Analisando o pensamento e relacionando-o a realidade atual, é notório que os preconceitos afetam de forma evidente a sociedade atual, já que a inclusão de pessoas com transtornos é complicada e dificilmente colocada em ação. Além de que o problema está inserido em todo o sistema educacional, em virtude de que todos os dias é comum presenciar diversos preconceitos e falta de oportunidades para pessoas portadoras de transtornos, - e apesar de ser um assunto de extrema importância, nunca é discutido em escolas ou em casa - então novamente a sociedade comete o mesmo erro e sofre com as mesmas consequências, mas ainda assim ignorando o assunto. Nessa perspectiva, pode-se afirmar que o descaso governamental com a educação, a escassa abordagem do autismo e outros transtornos em instituições de ensino e na mídia causam o agravamento da falta de inclusão e a nenhuma resolução para essa situação mais uma vez.De acordo com Nelson Mandela, ex-presidente da África do Sul, a educação é a arma mais poderosa que se pode usar para mudar o mundo. Sendo assim, é possível compreender que a educação e a abordagem do assunto em redes de comunicação assumem importantes papéis no presente e também no futuro da sociedade, entretanto o sistema educacional recebe grande negligência governamental, proporcionando a carência de conteúdos importantes, tal como a inclusão que pessoas autistas merecem.Portanto, fica evidente a importância dos estudos sobre maneiras de inclusão de pessoas com transtornos, e da falta que uma atenção maior para o sistema educacional gera ao país. Consequentemente cabe ao governo e ao Ministério da Educação elevarem a qualidade do conhecimento , por meio da inclusão de novas matérias, conteúdos e atividades – que devem ser acessíveis para todos os tipos de instituições – com o propósito de orientar e educar a todos sobre o grande desafio que é a inclusão. Em vista disso, ensinando as crianças e jovens a importância da abordagem desse assunto, assim educando o cidadão para que no futuro isso já não seja mais um problema e sim apenas uma lembrança de como evoluímos e deixamos preconceitos e exclusão de pessoas autistas no passado.",160,120,120,160,160,720
